97 97 97 97 97 97 97 97 97 97 97 97 97 97 97 97 97 97 97 97 97 97 97 97 97 
97 1 1 1 1 1 1 1 97 1 1 1 1 1 1 1 1 1 1 1 1 1 1 1 97 
97 1 1 1 1 1 1 1 97 1 1 1 1 1 1 1 1 1 1 1 1 1 1 1 97 
97 1 1 1 1 1 1 1 97 1 1 1 1 1 1 1 1 1 1 1 1 1 1 1 97 
97 1 1 113 1 1 1 1 1 1 1 1 1 1 1 1 1 1 1 1 1 1 1 1 97 
97 1 1 1 1 1 1 1 1 1 1 1 1 1 1 1 1 1 113 113 113 1 1 1 97 
97 1 1 1 1 1 1 1 97 1 1 1 1 1 1 1 1 97 1 1 1 97 1 1 97 
97 1 1 1 1 1 1 1 97 97 97 97 97 97 97 97 97 97 97 1 97 97 97 97 97 
97 1 1 1 1 1 1 1 97 1 1 1 1 1 1 1 1 97 1 1 1 1 1 1 97 
97 1 1 1 1 1 1 1 97 1 1 1 1 1 1 1 1 97 1 1 1 1 1 1 97 
97 97 97 1 1 97 97 97 97 1 1 1 1 113 1 1 1 97 1 1 1 1 1 1 97 
97 1 1 1 1 1 1 1 97 1 1 1 1 1 1 1 1 97 1 1 1 1 1 1 97 
97 1 1 1 1 1 1 1 1 1 1 1 1 1 1 1 1 97 1 1 1 1 1 1 97 
97 1 1 113 1 1 1 1 1 1 1 1 1 1 1 1 1 97 1 1 1 1 1 1 97 
97 1 1 1 1 1 1 1 97 1 1 1 1 1 1 1 1 97 1 1 1 1 1 1 97 
97 1 1 113 1 1 1 1 97 1 1 1 1 1 1 1 1 97 1 1 1 1 1 1 97 
97 1 1 1 1 1 1 1 97 1 1 1 1 1 1 1 1 97 1 1 1 1 1 1 97 
97 1 1 1 1 1 1 1 97 1 99 100 101 102 1 1 1 97 1 1 1 1 1 1 97 
97 97 97 97 97 97 97 97 97 97 97 116 117 97 97 97 97 97 97 97 97 97 97 97 97 
