1 1 1 2 3 2 3 2 3 1 1 1 1 1 1 1 1 55 54 55 54 55 54 55 41 
1 1 1 3 2 3 2 3 2 1 1 1 1 1 1 1 1 17 17 17 17 17 17 17 40 
1 1 1 17 17 17 17 17 17 3 2 3 2 3 2 3 2 17 17 17 65 17 17 65 41 
1 1 1 17 17 17 65 17 17 2 3 2 3 2 3 2 3 17 17 17 81 17 17 81 40 
1 1 1 17 17 17 81 17 17 3 2 3 2 3 21 19 19 19 2 3 2 3 2 19 41 
1 1 1 2 3 2 3 2 3 2 3 2 3 2 3 2 3 19 3 2 3 2 3 2 40 
1 1 1 3 2 3 2 3 2 3 2 3 2 3 2 3 2 3 2 3 2 3 2 19 41 
1 1 1 2 3 2 3 2 3 2 3 2 3 2 17 17 17 2 3 2 3 2 3 2 40 
1 1 1 3 2 30 29 28 27 26 25 24 23 22 17 17 2 3 2 3 2 3 2 19 41 
1 1 1 2 3 2 3 2 3 2 3 2 3 2 3 2 3 2 3 19 19 19 19 19 40 
1 1 1 3 2 3 2 3 2 3 2 3 2 3 2 3 2 3 21 19 84 3 19 19 41 
1 1 1 2 3 2 3 2 3 2 3 2 3 2 3 2 3 2 19 19 19 19 19 2 40 
1 1 1 3 2 3 2 3 2 3 2 3 2 3 2 3 2 3 2 19 19 19 2 3 54 
1 33 34 4 3 2 3 2 3 2 3 2 3 2 3 2 3 2 3 2 3 2 3 2 17 
1 49 50 20 18 5 2 3 2 3 2 3 2 3 2 3 2 3 2 3 2 3 2 3 17 
1 1 1 1 1 20 5 2 3 2 3 2 3 2 3 2 3 2 3 2 3 2 3 2 17 
1 1 1 1 1 1 20 18 18 18 18 18 18 18 18 18 18 18 18 18 18 18 18 18 18 
1 1 1 1 1 1 1 1 1 1 33 34 1 1 1 1 1 1 1 1 1 1 1 1 1 
1 1 1 1 1 1 1 1 1 1 49 50 1 1 1 1 1 1 1 1 1 1 1 1 1 
