1 81 10 10 10 9 10 9 10 9 10 9 10 9 10 9 10 9 10 9 10 9 10 82 1 
1 19 1 1 1 1 1 1 1 1 1 1 1 1 1 1 1 1 1 1 1 1 1 18 1 
1 19 1 1 1 1 1 1 1 1 1 1 1 1 1 1 1 1 1 1 1 1 1 18 1 
1 3 90 87 88 89 90 87 88 89 90 87 88 89 90 87 88 89 90 87 88 89 90 18 1 
1 19 1 1 1 1 1 1 1 1 1 1 1 1 1 1 1 1 1 1 1 1 69 18 1 
1 19 1 1 1 1 1 1 1 1 1 1 1 1 1 1 1 1 1 1 1 1 69 18 1 
1 3 1 1 2 81 9 10 9 10 9 10 9 10 9 10 9 10 82 19 1 1 69 18 1 
1 19 1 1 18 3 14 15 1 1 1 1 1 1 1 1 1 1 2 19 68 1 69 18 1 
1 3 1 1 2 3 30 31 1 1 1 1 1 1 1 1 1 1 2 3 78 1 69 8 9 
1 19 1 1 18 19 46 47 87 88 89 90 87 88 89 90 87 88 18 3 78 1 69 6 39 
1 19 1 1 2 3 1 1 1 1 1 1 1 1 1 1 1 1 2 19 78 1 69 54 55 
1 3 1 1 18 83 82 82 82 82 82 82 82 82 82 82 1 1 18 3 78 1 69 70 75 
1 3 1 1 8 9 9 9 9 9 9 9 9 9 9 11 1 1 2 3 78 1 85 86 90 
1 19 1 1 22 39 25 25 25 25 25 25 25 25 25 7 1 1 18 19 78 1 1 1 1 
1 3 1 1 54 55 25 25 25 25 25 25 25 25 25 12 1 1 2 3 78 1 1 1 1 
1 19 1 1 70 25 25 25 25 25 25 25 25 25 25 77 1 1 2 19 78 1 1 1 1 
1 19 1 1 86 87 88 87 88 89 90 87 88 89 90 93 1 1 2 83 81 81 81 81 81 
1 19 1 1 1 1 1 1 1 1 1 1 1 1 1 1 1 1 18 1 1 1 1 1 1 
1 83 82 82 82 82 82 82 82 82 82 82 82 82 82 82 82 82 84 1 1 1 1 1 1 
