151 119 102 116 116 116 116 116 116 116 116 102 116 102 116 116 116 102 116 102 116 116 116 102 116 
151 102 116 116 116 102 116 116 102 116 102 116 102 102 116 102 116 116 116 102 102 116 102 102 102 
151 119 116 102 116 102 116 116 102 116 116 116 116 102 116 116 116 102 116 116 116 116 102 116 102 
151 136 153 153 153 153 153 153 153 153 153 153 153 153 153 153 153 153 153 153 153 153 153 153 153 
151 1 1 1 1 1 1 1 1 1 1 1 1 1 1 1 1 1 1 1 1 1 1 1 129 
151 1 1 1 1 1 1 1 1 1 1 1 1 1 1 1 1 1 1 1 1 1 1 1 145 
151 93 116 116 116 116 116 94 1 1 129 131 1 93 116 116 116 116 116 116 116 116 94 1 145 
151 66 67 68 69 70 69 71 72 1 145 147 1 74 69 128 67 68 69 70 69 75 76 72 145 
151 82 83 84 85 86 85 87 88 1 145 147 1 90 85 144 83 84 85 85 86 85 87 88 145 
151 98 99 100 101 101 101 101 104 1 145 147 1 1 1 1 99 1 1 1 1 1 1 1 145 
151 1 129 130 130 130 130 130 130 130 146 146 130 130 130 130 130 130 130 130 130 130 130 130 148 
102 1 161 162 162 162 162 162 162 162 162 162 162 162 162 162 162 162 162 162 162 162 162 162 148 
116 1 1 1 1 1 1 1 1 1 1 1 1 1 1 1 1 1 1 1 1 1 1 1 145 
102 115 1 115 1 115 1 115 1 115 1 115 1 115 1 115 1 115 1 115 1 115 1 129 148 
114 114 114 114 114 114 114 114 114 114 1 114 114 114 114 114 114 114 114 114 114 1 1 161 148 
113 113 113 113 113 113 113 113 113 113 1 113 113 113 113 113 113 113 113 113 113 115 1 1 161 
113 113 113 113 113 113 113 113 113 113 114 113 113 113 113 113 113 113 113 113 113 1 1 1 1 
113 113 113 113 113 113 113 113 113 113 113 113 113 113 113 113 113 113 113 113 113 115 1 1 115 
113 113 113 113 113 113 113 113 113 113 113 113 113 113 113 113 113 113 113 113 113 114 114 114 114 
