1 1 1 1 1 1 50 1 81 9 10 9 9 10 9 10 9 11 78 69 8 9 9 11 78 
1 1 1 1 1 1 1 1 19 87 88 89 90 87 88 89 90 93 94 85 86 87 90 93 94 
1 1 1 50 1 1 50 1 3 68 49 1 1 1 1 1 1 1 1 1 1 49 1 1 1 
1 50 1 1 50 1 1 1 19 78 1 1 1 1 1 49 1 1 1 1 1 1 1 49 1 
1 1 1 50 1 1 1 50 3 78 49 1 1 1 1 1 1 1 1 1 50 50 1 1 1 
1 1 1 1 1 1 1 1 19 78 1 1 1 1 50 1 50 1 1 1 1 1 50 1 1 
1 50 1 1 1 1 50 1 3 78 1 1 1 1 1 1 1 1 1 1 1 1 1 1 1 
1 1 1 81 10 10 10 10 11 78 1 1 1 1 1 1 1 1 1 1 1 1 1 1 1 
1 1 1 19 88 88 89 90 93 94 1 1 49 1 1 1 50 1 1 1 1 1 1 1 1 
1 1 1 19 68 1 1 1 1 1 1 1 1 1 1 1 1 1 50 49 1 1 1 50 1 
1 50 1 3 78 1 50 1 1 50 49 1 1 1 50 1 1 1 1 1 1 1 1 1 1 
10 10 82 19 78 1 81 81 1 1 1 1 1 1 1 1 1 49 1 1 1 50 1 1 1 
89 90 8 11 78 53 18 19 68 1 1 1 50 1 1 50 1 1 1 1 1 50 1 50 1 
1 85 86 93 94 69 18 3 78 1 1 1 1 1 1 1 1 1 50 1 1 1 1 1 1 
50 1 1 1 1 69 18 19 78 1 1 1 1 1 1 1 1 1 1 1 1 1 1 1 1 
1 50 1 1 50 69 2 3 78 49 1 1 1 1 1 1 1 1 1 1 1 1 1 1 1 
81 81 1 1 1 69 18 19 78 1 1 1 1 49 1 1 1 1 50 1 1 1 53 22 39 
1 3 68 1 50 69 18 3 78 1 1 50 1 1 1 50 1 1 1 1 1 1 69 54 55 
1 83 81 81 81 81 84 19 78 1 1 1 1 1 1 1 1 1 1 1 1 1 69 70 25 
