1 1 1 1 1 1 1 1 1 1 1 1 1 1 1 1 1 1 1 1 1 1 1 1 1 
1 1 1 2 3 3 3 3 3 3 3 3 3 3 3 3 3 3 3 3 3 11 1 1 1 
1 1 1 18 3 3 3 3 3 3 3 3 3 3 3 3 3 3 3 3 3 27 1 1 1 
1 1 1 34 35 36 37 36 37 36 37 36 37 36 37 36 37 36 37 36 42 43 1 1 1 
1 1 1 50 51 52 52 52 52 52 52 52 52 52 52 52 52 52 52 52 58 59 1 1 1 
1 1 2 66 53 53 53 53 53 53 53 53 53 53 53 53 53 53 53 53 53 75 11 1 1 
1 1 18 82 53 53 53 53 53 53 89 90 53 105 106 53 53 53 53 53 53 91 27 1 1 
1 1 34 98 53 53 53 89 90 53 53 53 53 53 53 53 105 106 53 53 53 107 43 1 1 
1 1 50 53 53 53 53 53 53 53 53 53 53 53 53 53 53 53 53 53 53 53 59 1 1 
1 2 66 53 53 53 89 90 53 53 53 53 53 53 53 53 53 105 106 53 53 53 75 11 1 
1 18 82 53 53 53 53 53 53 53 53 53 53 53 53 53 53 53 53 53 53 53 91 27 1 
1 34 98 53 53 53 53 89 90 53 53 53 53 53 53 53 105 106 53 53 53 53 107 43 1 
1 50 53 53 53 53 53 53 53 53 89 90 53 105 106 53 53 53 53 53 53 53 53 59 1 
1 66 53 53 53 53 53 53 53 53 53 53 53 53 53 53 53 53 53 53 53 53 53 75 1 
1 82 53 53 53 53 53 53 53 53 53 53 53 53 53 53 53 53 53 53 53 53 53 91 1 
1 98 53 53 53 53 53 53 53 53 53 53 53 53 53 53 53 53 53 53 53 53 53 107 1 
1 1 1 1 1 1 1 1 1 1 1 1 1 1 1 1 1 1 1 1 1 1 1 1 1 
1 1 1 1 1 1 1 1 1 1 1 1 1 1 1 1 1 1 1 1 1 1 1 1 1 
1 1 1 1 1 1 1 1 1 1 1 1 1 1 1 1 1 1 1 1 1 1 1 1 1 
