1 50 19 32 57 58 21 76 77 148 103 86 87 70 25 25 20 63 2 49 1 17 1 1 1 
1 81 11 21 73 74 77 90 93 116 117 119 1 86 87 88 70 79 18 1 50 17 1 1 1 
49 19 7 77 89 90 93 49 1 132 118 135 1 50 1 1 86 87 8 82 1 17 1 1 1 
81 11 23 93 94 1 1 1 50 100 117 103 102 102 1 1 1 69 22 2 1 17 1 1 1 
3 23 16 78 1 1 1 101 100 117 117 117 151 148 135 49 66 69 54 18 1 17 1 1 1 
19 12 93 94 1 1 116 117 117 118 117 151 50 167 1 1 50 69 70 2 49 17 1 1 1 
3 77 78 1 1 1 100 117 117 151 149 102 100 117 135 1 1 85 86 8 9 17 1 1 1 
19 93 94 50 1 116 117 133 134 164 100 133 134 151 1 49 1 1 69 28 44 17 1 1 1 
3 78 1 1 1 116 117 117 117 103 137 148 117 119 1 1 1 50 69 20 60 17 1 1 1 
11 78 49 1 1 1 148 117 117 117 117 103 149 1 1 1 1 1 69 70 75 17 1 1 1 
23 78 1 1 1 50 1 149 148 117 117 151 1 1 1 49 1 1 24 1 1 17 1 1 1 
23 78 1 1 1 1 1 1 132 118 117 135 1 1 1 1 1 24 1 1 1 17 1 1 1 
24 78 53 123 124 125 68 1 116 117 151 1 49 26 25 24 24 1 101 167 1 17 1 1 1 
49 25 138 139 140 141 142 1 1 148 103 1 1 86 26 9 82 116 117 117 103 17 1 1 1 
50 1 1 1 1 50 1 83 1 100 117 135 49 1 86 87 18 1 148 117 133 17 1 1 1 
17 17 17 17 17 17 17 17 17 17 17 17 17 17 17 17 17 17 17 17 17 17 1 1 1 
1 1 1 1 1 1 1 1 1 1 1 1 1 1 1 1 1 1 1 1 1 1 1 1 1 
1 1 1 1 1 1 1 1 1 1 1 1 1 1 1 1 1 1 1 1 1 1 1 1 1 
1 1 1 1 1 1 1 1 1 1 1 1 1 1 1 1 1 1 1 1 1 1 1 1 1 
