114 1 161 146 146 146 210 116 116 116 116 116 116 116 116 146 146 162 163 1 113 17 1 1 1 
113 1 1 1 1 1 210 116 116 116 116 116 116 116 116 1 1 1 131 1 113 17 1 1 1 
113 1 1 210 102 210 210 116 116 116 116 116 116 116 116 210 102 210 146 130 113 1 1 1 1 
1 1 1 116 102 210 209 116 116 116 116 116 116 116 211 210 102 210 146 146 146 1 1 1 1 
210 102 210 209 102 211 146 146 146 146 146 146 146 146 146 209 102 211 116 102 210 17 1 1 1 
210 102 210 146 146 146 146 146 146 146 146 146 146 146 146 146 146 146 116 102 210 1 1 1 1 
209 102 211 146 146 146 163 145 146 146 146 132 162 162 133 146 146 146 209 102 211 113 1 1 1 
146 146 146 146 146 147 1 145 146 146 146 147 1 1 145 146 146 146 146 146 146 113 1 1 1 
146 146 146 132 162 163 1 145 133 146 146 148 131 1 145 146 146 146 146 146 146 113 1 1 1 
146 146 146 148 130 131 129 146 146 146 146 146 147 1 161 162 133 146 146 132 163 113 1 1 1 
161 133 146 146 146 148 148 132 162 133 146 146 148 131 1 129 146 146 132 163 1 113 1 1 1 
1 145 146 146 146 146 132 163 1 161 162 146 146 148 130 146 146 146 147 1 1 113 1 1 1 
1 161 162 162 162 162 163 1 1 1 1 161 162 162 162 162 162 162 163 1 1 113 1 1 1 
114 114 114 114 114 114 114 114 114 114 114 114 114 114 114 114 114 114 114 114 114 113 1 1 1 
113 113 113 113 113 113 113 113 113 113 113 113 113 113 113 113 113 113 113 113 113 113 1 1 1 
113 113 113 113 113 113 113 113 113 113 113 113 113 113 113 113 113 113 113 113 113 113 1 1 1 
1 1 1 1 1 1 1 1 1 1 1 1 1 1 1 1 1 1 1 1 1 1 1 1 1 
1 1 1 1 1 1 1 1 1 1 1 1 1 1 1 1 1 1 1 1 1 1 1 1 1 
1 1 1 1 1 1 1 1 1 1 1 1 1 1 1 1 1 1 1 1 1 1 1 1 1 
