1 1 1 1 49 1 1 19 78 1 1 1 1 1 1 1 1 1 1 1 50 1 85 86 87 
1 1 50 1 1 1 1 3 78 1 1 50 1 1 50 1 1 1 1 1 1 1 1 1 1 
1 1 1 1 49 1 49 19 78 1 1 1 1 1 1 1 1 1 50 1 1 1 1 50 1 
10 10 9 9 82 81 10 11 78 1 1 1 1 1 1 1 1 1 1 1 1 1 1 1 1 
24 24 24 41 2 3 39 23 78 1 1 1 1 1 50 1 1 50 1 50 1 1 1 1 1 
42 43 44 57 18 19 55 12 78 50 1 1 50 1 1 1 1 1 1 1 1 1 50 1 1 
58 75 60 61 2 3 76 77 78 1 1 1 1 1 1 1 1 1 1 50 1 1 1 1 1 
88 90 88 89 18 19 90 93 94 1 50 1 1 1 1 1 1 1 1 1 1 50 1 1 1 
1 1 1 69 1 1 78 1 1 1 1 1 1 1 50 1 1 1 1 1 1 1 1 1 50 
1 50 1 69 1 1 78 50 1 1 1 1 1 1 50 1 1 1 1 1 1 50 1 1 1 
1 50 1 69 1 1 78 1 1 50 1 50 1 1 1 1 1 1 1 1 1 1 1 1 1 
1 1 1 69 1 1 78 1 1 1 1 1 1 1 1 1 1 1 50 1 1 1 1 1 1 
83 83 83 84 84 83 83 83 83 83 83 83 83 83 83 83 83 68 1 1 1 1 50 1 1 
1 1 1 1 1 1 49 1 1 1 1 49 1 1 1 1 19 78 1 1 1 1 1 1 1 
1 1 49 1 1 1 1 1 1 1 1 1 49 1 1 1 83 83 83 83 83 83 83 83 83 
1 1 1 1 1 1 49 1 1 1 1 49 50 1 1 1 1 49 1 50 1 1 1 1 1 
10 10 10 9 10 9 10 9 10 9 10 9 9 10 9 10 9 10 9 10 9 9 10 9 10 
24 39 24 24 24 24 24 42 43 44 29 24 24 24 41 24 24 39 24 24 41 24 42 43 44 
62 55 56 24 24 24 24 58 25 60 45 24 24 24 57 24 62 55 56 24 57 24 58 25 60 
