1 1 1 1 1 1 1 1 1 1 1 50 1 1 1 1 1 1 1 1 1 1 1 50 1 
1 1 50 1 1 1 1 1 1 1 1 1 1 1 1 1 1 50 1 1 1 1 1 1 1 
1 1 1 1 1 1 1 1 1 1 1 1 1 1 1 1 1 1 1 1 1 49 1 50 1 
1 1 1 1 49 1 1 1 1 1 1 1 1 1 1 1 1 49 1 1 1 1 1 1 1 
1 1 49 1 1 1 1 1 1 1 1 1 1 1 1 50 1 1 1 1 1 1 50 1 50 
1 1 1 49 50 1 53 28 44 24 24 39 7 68 50 1 1 1 49 1 1 1 1 1 1 
1 1 1 1 1 1 69 20 60 61 62 55 12 78 1 1 50 1 1 1 1 1 1 1 1 
1 1 1 1 1 1 69 70 75 25 25 76 77 78 50 1 1 1 1 1 1 49 1 1 1 
1 1 1 1 49 1 85 86 87 88 89 90 93 94 1 1 1 1 1 1 1 1 1 1 1 
1 1 1 1 1 1 1 1 1 1 1 1 1 50 1 1 1 49 1 1 49 1 1 1 50 
1 50 1 50 1 1 1 1 1 1 1 1 1 1 1 1 1 1 1 1 1 1 1 1 1 
1 1 1 1 1 50 1 1 1 1 1 1 1 1 1 1 1 1 1 1 1 1 1 1 1 
1 1 1 1 1 1 1 1 49 1 50 1 1 1 53 8 9 10 11 68 1 1 1 49 1 
1 1 1 50 1 1 1 1 1 1 1 1 1 1 85 86 87 88 93 94 1 1 1 1 1 
1 1 1 1 1 1 1 1 1 49 1 1 1 1 1 1 1 1 1 1 49 1 1 1 1 
1 1 1 1 1 1 1 1 1 1 1 1 1 50 1 1 50 1 1 1 1 1 1 1 1 
39 7 68 1 1 1 1 1 1 1 1 1 1 1 1 1 1 1 1 1 1 50 1 1 50 
55 12 78 1 1 1 50 1 1 1 50 1 1 1 1 49 1 1 1 1 1 1 1 1 1 
75 77 78 1 1 1 1 1 1 1 1 1 1 1 1 1 1 1 1 53 81 81 81 81 81 
