1 1 1 149 148 117 103 132 135 1 1 1 50 1 1 1 1 1 1 1 1 1 1 1 1 1 1 1 149 148 117 103 132 135 1 1 1 50 1 1 1 1 1 1 1 1 1 1 1 1 1 1 1 149 148 117 103 132 135 1 1 1 50 1 1 1 1 1 1 1 1 1 1 1 1 1 1 1 149 148 117 103 132 135 1 1 1 50 1 1 1 1 1 1 1 1 1 1 1 1 
1 1 1 1 1 148 117 103 101 102 1 1 1 1 1 1 1 1 50 1 1 1 1 1 1 1 1 1 1 1 148 117 103 101 102 1 1 1 1 1 1 1 1 50 1 1 1 1 1 1 1 1 1 1 1 148 117 103 101 102 1 1 1 1 1 1 1 1 50 1 1 1 1 1 1 1 1 1 1 1 148 117 103 101 102 1 1 1 1 1 1 1 1 50 1 1 1 1 1 1 
1 49 1 1 1 1 165 148 117 117 103 101 1 1 1 101 1 1 1 1 1 49 1 1 1 1 49 1 1 1 1 165 148 117 117 103 101 1 1 1 101 1 1 1 1 1 49 1 1 1 1 49 1 1 1 1 165 148 117 117 103 101 1 1 1 101 1 1 1 1 1 49 1 1 1 1 49 1 1 1 1 165 148 117 117 103 101 1 1 1 101 1 1 1 1 1 49 1 1 1 
1 1 1 1 1 1 1 1 148 117 117 117 135 1 1 148 103 102 1 1 1 1 1 1 1 1 1 1 1 1 1 1 1 148 117 117 117 135 1 1 148 103 102 1 1 1 1 1 1 1 1 1 1 1 1 1 1 1 148 117 117 117 135 1 1 148 103 102 1 1 1 1 1 1 1 1 1 1 1 1 1 1 1 148 117 117 117 135 1 1 148 103 102 1 1 1 1 1 1 1 
1 1 1 1 1 1 1 1 100 117 117 117 103 167 101 100 118 117 103 102 1 1 1 1 1 1 1 1 1 1 1 1 1 100 117 117 117 103 167 101 100 118 117 103 102 1 1 1 1 1 1 1 1 1 1 1 1 1 100 117 117 117 103 167 101 100 118 117 103 102 1 1 1 1 1 1 1 1 1 1 1 1 1 100 117 117 117 103 167 101 100 118 117 103 102 1 1 1 1 1 
1 1 1 1 1 1 1 116 117 117 117 151 150 148 117 117 117 117 117 117 135 1 49 1 1 1 1 1 1 1 1 1 116 117 117 117 151 150 148 117 117 117 117 117 117 135 1 49 1 1 1 1 1 1 1 1 1 116 117 117 117 151 150 148 117 117 117 117 117 117 135 1 49 1 1 1 1 1 1 1 1 1 116 117 117 117 151 150 148 117 117 117 117 117 117 135 1 49 1 1 
1 1 50 1 1 100 103 166 117 151 150 1 49 1 148 117 151 148 117 117 103 1 1 1 1 1 1 50 1 1 100 103 166 117 151 150 1 49 1 148 117 151 148 117 117 103 1 1 1 1 1 1 50 1 1 100 103 166 117 151 150 1 49 1 148 117 151 148 117 117 103 1 1 1 1 1 1 50 1 1 100 103 166 117 151 150 1 49 1 148 117 151 148 117 117 103 1 1 1 1 
100 135 1 102 100 117 117 164 149 1 1 1 1 1 116 117 103 100 117 117 117 103 1 1 102 100 135 1 102 100 117 117 164 149 1 1 1 1 1 116 117 103 100 117 117 117 103 1 1 102 100 135 1 102 100 117 117 164 149 1 1 1 1 1 116 117 103 100 117 117 117 103 1 1 102 100 135 1 102 100 117 117 164 149 1 1 1 1 1 116 117 103 100 117 117 117 103 1 1 102 
117 103 100 117 117 117 151 1 1 1 104 105 106 1 1 148 117 117 117 117 117 117 103 100 117 117 103 100 117 117 117 151 1 1 1 104 105 106 1 1 148 117 117 117 117 117 117 103 100 117 117 103 100 117 117 117 151 1 1 1 104 105 106 1 1 148 117 117 117 117 117 117 103 100 117 117 103 100 117 117 117 151 1 1 1 104 105 106 1 1 148 117 117 117 117 117 117 103 100 117 
117 117 117 151 148 117 135 1 1 1 120 121 122 1 1 132 117 117 117 118 151 149 148 151 148 117 117 117 151 148 117 135 1 1 1 120 121 122 1 1 132 117 117 117 118 151 149 148 151 148 117 117 117 151 148 117 135 1 1 1 120 121 122 1 1 132 117 117 117 118 151 149 148 151 148 117 117 117 151 148 117 135 1 1 1 120 121 122 1 1 132 117 117 117 118 151 149 148 151 148 
150 149 150 1 166 151 1 1 49 1 1 1 1 1 1 100 117 117 151 137 1 1 102 1 1 150 149 150 1 166 151 1 1 49 1 1 1 1 1 1 100 117 117 151 137 1 1 102 1 1 150 149 150 1 166 151 1 1 49 1 1 1 1 1 1 100 117 117 151 137 1 1 102 1 1 150 149 150 1 166 151 1 1 49 1 1 1 1 1 1 100 117 117 151 137 1 1 102 1 1 
1 1 1 1 116 103 1 1 1 1 1 1 1 1 100 133 134 117 136 151 49 100 118 164 1 1 1 1 1 116 103 1 1 1 1 1 1 1 1 100 133 134 117 136 151 49 100 118 164 1 1 1 1 1 116 103 1 1 1 1 1 1 1 1 100 133 134 117 136 151 49 100 118 164 1 1 1 1 1 116 103 1 1 1 1 1 1 1 1 100 133 134 117 136 151 49 100 118 164 1 
1 1 1 1 1 149 1 1 1 1 50 1 100 136 117 151 148 117 103 167 100 117 151 1 1 1 1 1 1 1 149 1 1 1 1 50 1 100 136 117 151 148 117 103 167 100 117 151 1 1 1 1 1 1 1 149 1 1 1 1 50 1 100 136 117 151 148 117 103 167 100 117 151 1 1 1 1 1 1 1 149 1 1 1 1 50 1 100 136 117 151 148 117 103 167 100 117 151 1 1 
1 1 1 1 1 1 1 101 102 1 1 132 151 1 149 1 1 148 117 117 151 149 1 1 1 1 1 1 1 1 1 1 101 102 1 1 132 151 1 149 1 1 148 117 117 151 149 1 1 1 1 1 1 1 1 1 1 101 102 1 1 132 151 1 149 1 1 148 117 117 151 149 1 1 1 1 1 1 1 1 1 1 101 102 1 1 132 151 1 149 1 1 148 117 117 151 149 1 1 1 
1 1 1 1 1 1 132 133 134 103 101 100 135 1 1 1 49 1 148 151 1 1 1 1 1 1 1 1 1 1 1 132 133 134 103 101 100 135 1 1 1 49 1 148 151 1 1 1 1 1 1 1 1 1 1 1 132 133 134 103 101 100 135 1 1 1 49 1 148 151 1 1 1 1 1 1 1 1 1 1 1 132 133 134 103 101 100 135 1 1 1 49 1 148 151 1 1 1 1 1 
1 50 1 1 116 103 100 117 117 117 117 151 1 1 1 1 1 1 1 1 1 1 1 1 1 1 50 1 1 116 103 100 117 117 117 117 151 1 1 1 1 1 1 1 1 1 1 1 1 1 1 50 1 1 116 103 100 117 117 117 117 151 1 1 1 1 1 1 1 1 1 1 1 1 1 1 50 1 1 116 103 100 117 117 117 117 151 1 1 1 1 1 1 1 1 1 1 1 1 1 
1 1 1 1 132 117 117 117 117 151 149 1 1 1 1 1 1 1 1 1 1 1 49 1 1 1 1 1 1 132 117 117 117 117 151 149 1 1 1 1 1 1 1 1 1 1 1 49 1 1 1 1 1 1 132 117 117 117 117 151 149 1 1 1 1 1 1 1 1 1 1 1 49 1 1 1 1 1 1 132 117 117 117 117 151 149 1 1 1 1 1 1 1 1 1 1 1 49 1 1 
1 1 1 1 100 117 117 117 151 1 1 1 50 1 1 1 1 1 1 1 1 1 1 1 1 1 1 1 1 100 117 117 117 151 1 1 1 50 1 1 1 1 1 1 1 1 1 1 1 1 1 1 1 1 100 117 117 117 151 1 1 1 50 1 1 1 1 1 1 1 1 1 1 1 1 1 1 1 1 100 117 117 117 151 1 1 1 50 1 1 1 1 1 1 1 1 1 1 1 1 
1 1 1 100 117 118 151 150 1 1 1 1 1 1 1 1 1 1 1 1 1 1 1 1 1 1 1 1 100 117 118 151 150 1 1 1 1 1 1 1 1 1 1 1 1 1 1 1 1 1 1 1 1 100 117 118 151 150 1 1 1 1 1 1 1 1 1 1 1 1 1 1 1 1 1 1 1 1 100 117 118 151 150 1 1 1 1 1 1 1 1 1 1 1 1 1 1 1 1 1 
1 1 1 149 148 117 103 132 135 1 1 1 50 1 1 1 1 1 1 1 1 1 1 1 1 1 1 1 149 148 117 103 132 135 1 1 1 50 1 1 1 1 1 1 1 1 1 1 1 1 1 1 1 149 148 117 103 132 135 1 1 1 50 1 1 1 1 1 1 1 1 1 1 1 1 1 1 1 149 148 117 103 132 135 1 1 1 50 1 1 1 1 1 1 1 1 1 1 1 1 
1 1 1 1 1 148 117 103 101 102 1 1 1 1 1 1 1 1 50 1 1 1 1 1 1 1 1 1 1 1 148 117 103 101 102 1 1 1 1 1 1 1 1 50 1 1 1 1 1 1 1 1 1 1 1 148 117 103 101 102 1 1 1 1 1 1 1 1 50 1 1 1 1 1 1 1 1 1 1 1 148 117 103 101 102 1 1 1 1 1 1 1 1 50 1 1 1 1 1 1 
1 49 1 1 1 1 165 148 117 117 103 101 1 1 1 101 1 1 1 1 1 49 1 1 1 1 49 1 1 1 1 165 148 117 117 103 101 1 1 1 101 1 1 1 1 1 49 1 1 1 1 49 1 1 1 1 165 148 117 117 103 101 1 1 1 101 1 1 1 1 1 49 1 1 1 1 49 1 1 1 1 165 148 117 117 103 101 1 1 1 101 1 1 1 1 1 49 1 1 1 
1 1 1 1 1 1 1 1 148 117 117 117 135 1 1 148 103 102 1 1 1 1 1 1 1 1 1 1 1 1 1 1 1 148 117 117 117 135 1 1 148 103 102 1 1 1 1 1 1 1 1 1 1 1 1 1 1 1 148 117 117 117 135 1 1 148 103 102 1 1 1 1 1 1 1 1 1 1 1 1 1 1 1 148 117 117 117 135 1 1 148 103 102 1 1 1 1 1 1 1 
1 1 1 1 1 1 1 1 100 117 117 117 103 167 101 100 118 117 103 102 1 1 1 1 1 1 1 1 1 1 1 1 1 100 117 117 117 103 167 101 100 118 117 103 102 1 1 1 1 1 1 1 1 1 1 1 1 1 100 117 117 117 103 167 101 100 118 117 103 102 1 1 1 1 1 1 1 1 1 1 1 1 1 100 117 117 117 103 167 101 100 118 117 103 102 1 1 1 1 1 
1 1 1 1 1 1 1 116 117 117 117 151 150 148 117 117 117 117 117 117 135 1 49 1 1 1 1 1 1 1 1 1 116 117 117 117 151 150 148 117 117 117 117 117 117 135 1 49 1 1 1 1 1 1 1 1 1 116 117 117 117 151 150 148 117 117 117 117 117 117 135 1 49 1 1 1 1 1 1 1 1 1 116 117 117 117 151 150 148 117 117 117 117 117 117 135 1 49 1 1 
1 1 50 1 1 100 103 166 117 151 150 1 49 1 148 117 151 148 117 117 103 1 1 1 1 1 1 50 1 1 100 103 166 117 151 150 1 49 1 148 117 151 148 117 117 103 1 1 1 1 1 1 50 1 1 100 103 166 117 151 150 1 49 1 148 117 151 148 117 117 103 1 1 1 1 1 1 50 1 1 100 103 166 117 151 150 1 49 1 148 117 151 148 117 117 103 1 1 1 1 
100 135 1 102 100 117 117 164 149 1 1 1 1 1 116 117 103 100 117 117 117 103 1 1 102 100 135 1 102 100 117 117 164 149 1 1 1 1 1 116 117 103 100 117 117 117 103 1 1 102 100 135 1 102 100 117 117 164 149 1 1 1 1 1 116 117 103 100 117 117 117 103 1 1 102 100 135 1 102 100 117 117 164 149 1 1 1 1 1 116 117 103 100 117 117 117 103 1 1 102 
117 103 100 117 117 117 151 1 1 1 104 105 106 1 1 148 117 117 117 117 117 117 103 100 117 117 103 100 117 117 117 151 1 1 1 104 105 106 1 1 148 117 117 117 117 117 117 103 100 117 117 103 100 117 117 117 151 1 1 1 104 105 106 1 1 148 117 117 117 117 117 117 103 100 117 117 103 100 117 117 117 151 1 1 1 104 105 106 1 1 148 117 117 117 117 117 117 103 100 117 
117 117 117 151 148 117 135 1 1 1 120 121 122 1 1 132 117 117 117 118 151 149 148 151 148 117 117 117 151 148 117 135 1 1 1 120 121 122 1 1 132 117 117 117 118 151 149 148 151 148 117 117 117 151 148 117 135 1 1 1 120 121 122 1 1 132 117 117 117 118 151 149 148 151 148 117 117 117 151 148 117 135 1 1 1 120 121 122 1 1 132 117 117 117 118 151 149 148 151 148 
150 149 150 1 166 151 1 1 49 1 1 1 1 1 1 100 117 117 151 137 1 1 102 1 1 150 149 150 1 166 151 1 1 49 1 1 1 1 1 1 100 117 117 151 137 1 1 102 1 1 150 149 150 1 166 151 1 1 49 1 1 1 1 1 1 100 117 117 151 137 1 1 102 1 1 150 149 150 1 166 151 1 1 49 1 1 1 1 1 1 100 117 117 151 137 1 1 102 1 1 
1 1 1 1 116 103 1 1 1 1 1 1 1 1 100 133 134 117 136 151 49 100 118 164 1 1 1 1 1 116 103 1 1 1 1 1 1 1 1 100 133 134 117 136 151 49 100 118 164 1 1 1 1 1 116 103 1 1 1 1 1 1 1 1 100 133 134 117 136 151 49 100 118 164 1 1 1 1 1 116 103 1 1 1 1 1 1 1 1 100 133 134 117 136 151 49 100 118 164 1 
1 1 1 1 1 149 1 1 1 1 50 1 100 136 117 151 148 117 103 167 100 117 151 1 1 1 1 1 1 1 149 1 1 1 1 50 1 100 136 117 151 148 117 103 167 100 117 151 1 1 1 1 1 1 1 149 1 1 1 1 50 1 100 136 117 151 148 117 103 167 100 117 151 1 1 1 1 1 1 1 149 1 1 1 1 50 1 100 136 117 151 148 117 103 167 100 117 151 1 1 
1 1 1 1 1 1 1 101 102 1 1 132 151 1 149 1 1 148 117 117 151 149 1 1 1 1 1 1 1 1 1 1 101 102 1 1 132 151 1 149 1 1 148 117 117 151 149 1 1 1 1 1 1 1 1 1 1 101 102 1 1 132 151 1 149 1 1 148 117 117 151 149 1 1 1 1 1 1 1 1 1 1 101 102 1 1 132 151 1 149 1 1 148 117 117 151 149 1 1 1 
1 1 1 1 1 1 132 133 134 103 101 100 135 1 1 1 49 1 148 151 1 1 1 1 1 1 1 1 1 1 1 132 133 134 103 101 100 135 1 1 1 49 1 148 151 1 1 1 1 1 1 1 1 1 1 1 132 133 134 103 101 100 135 1 1 1 49 1 148 151 1 1 1 1 1 1 1 1 1 1 1 132 133 134 103 101 100 135 1 1 1 49 1 148 151 1 1 1 1 1 
1 50 1 1 116 103 100 117 117 117 117 151 1 1 1 1 1 1 1 1 1 1 1 1 1 1 50 1 1 116 103 100 117 117 117 117 151 1 1 1 1 1 1 1 1 1 1 1 1 1 1 50 1 1 116 103 100 117 117 117 117 151 1 1 1 1 1 1 1 1 1 1 1 1 1 1 50 1 1 116 103 100 117 117 117 117 151 1 1 1 1 1 1 1 1 1 1 1 1 1 
1 1 1 1 132 117 117 117 117 151 149 1 1 1 1 1 1 1 1 1 1 1 49 1 1 1 1 1 1 132 117 117 117 117 151 149 1 1 1 1 1 1 1 1 1 1 1 49 1 1 1 1 1 1 132 117 117 117 117 151 149 1 1 1 1 1 1 1 1 1 1 1 49 1 1 1 1 1 1 132 117 117 117 117 151 149 1 1 1 1 1 1 1 1 1 1 1 49 1 1 
1 1 1 1 100 117 117 117 151 1 1 1 50 1 1 1 1 1 1 1 1 1 1 1 1 1 1 1 1 100 117 117 117 151 1 1 1 50 1 1 1 1 1 1 1 1 1 1 1 1 1 1 1 1 100 117 117 117 151 1 1 1 50 1 1 1 1 1 1 1 1 1 1 1 1 1 1 1 1 100 117 117 117 151 1 1 1 50 1 1 1 1 1 1 1 1 1 1 1 1 
1 1 1 100 117 118 151 150 1 1 1 1 1 1 1 1 1 1 1 1 1 1 1 1 1 1 1 1 100 117 118 151 150 1 1 1 1 1 1 1 1 1 1 1 1 1 1 1 1 1 1 1 1 100 117 118 151 150 1 1 1 1 1 1 1 1 1 1 1 1 1 1 1 1 1 1 1 1 100 117 118 151 150 1 1 1 1 1 1 1 1 1 1 1 1 1 1 1 1 1 
1 1 1 149 148 117 103 132 135 1 1 1 50 1 1 1 1 1 1 1 1 1 1 1 1 1 1 1 149 148 117 103 132 135 1 1 1 50 1 1 1 1 1 1 1 1 1 1 1 1 1 1 1 149 148 117 103 132 135 1 1 1 50 1 1 1 1 1 1 1 1 1 1 1 1 1 1 1 149 148 117 103 132 135 1 1 1 50 1 1 1 1 1 1 1 1 1 1 1 1 
1 1 1 1 1 148 117 103 101 102 1 1 1 1 1 1 1 1 50 1 1 1 1 1 1 1 1 1 1 1 148 117 103 101 102 1 1 1 1 1 1 1 1 50 1 1 1 1 1 1 1 1 1 1 1 148 117 103 101 102 1 1 1 1 1 1 1 1 50 1 1 1 1 1 1 1 1 1 1 1 148 117 103 101 102 1 1 1 1 1 1 1 1 50 1 1 1 1 1 1 
1 49 1 1 1 1 165 148 117 117 103 101 1 1 1 101 1 1 1 1 1 49 1 1 1 1 49 1 1 1 1 165 148 117 117 103 101 1 1 1 101 1 1 1 1 1 49 1 1 1 1 49 1 1 1 1 165 148 117 117 103 101 1 1 1 101 1 1 1 1 1 49 1 1 1 1 49 1 1 1 1 165 148 117 117 103 101 1 1 1 101 1 1 1 1 1 49 1 1 1 
1 1 1 1 1 1 1 1 148 117 117 117 135 1 1 148 103 102 1 1 1 1 1 1 1 1 1 1 1 1 1 1 1 148 117 117 117 135 1 1 148 103 102 1 1 1 1 1 1 1 1 1 1 1 1 1 1 1 148 117 117 117 135 1 1 148 103 102 1 1 1 1 1 1 1 1 1 1 1 1 1 1 1 148 117 117 117 135 1 1 148 103 102 1 1 1 1 1 1 1 
1 1 1 1 1 1 1 1 100 117 117 117 103 167 101 100 118 117 103 102 1 1 1 1 1 1 1 1 1 1 1 1 1 100 117 117 117 103 167 101 100 118 117 103 102 1 1 1 1 1 1 1 1 1 1 1 1 1 100 117 117 117 103 167 101 100 118 117 103 102 1 1 1 1 1 1 1 1 1 1 1 1 1 100 117 117 117 103 167 101 100 118 117 103 102 1 1 1 1 1 
1 1 1 1 1 1 1 116 117 117 117 151 150 148 117 117 117 117 117 117 135 1 49 1 1 1 1 1 1 1 1 1 116 117 117 117 151 150 148 117 117 117 117 117 117 135 1 49 1 1 1 1 1 1 1 1 1 116 117 117 117 151 150 148 117 117 117 117 117 117 135 1 49 1 1 1 1 1 1 1 1 1 116 117 117 117 151 150 148 117 117 117 117 117 117 135 1 49 1 1 
1 1 50 1 1 100 103 166 117 151 150 1 49 1 148 117 151 148 117 117 103 1 1 1 1 1 1 50 1 1 100 103 166 117 151 150 1 49 1 148 117 151 148 117 117 103 1 1 1 1 1 1 50 1 1 100 103 166 117 151 150 1 49 1 148 117 151 148 117 117 103 1 1 1 1 1 1 50 1 1 100 103 166 117 151 150 1 49 1 148 117 151 148 117 117 103 1 1 1 1 
100 135 1 102 100 117 117 164 149 1 1 1 1 1 116 117 103 100 117 117 117 103 1 1 102 100 135 1 102 100 117 117 164 149 1 1 1 1 1 116 117 103 100 117 117 117 103 1 1 102 100 135 1 102 100 117 117 164 149 1 1 1 1 1 116 117 103 100 117 117 117 103 1 1 102 100 135 1 102 100 117 117 164 149 1 1 1 1 1 116 117 103 100 117 117 117 103 1 1 102 
117 103 100 117 117 117 151 1 1 1 104 105 106 1 1 148 117 117 117 117 117 117 103 100 117 117 103 100 117 117 117 151 1 1 1 104 105 106 1 1 148 117 117 117 117 117 117 103 100 117 117 103 100 117 117 117 151 1 1 1 104 105 106 1 1 148 117 117 117 117 117 117 103 100 117 117 103 100 117 117 117 151 1 1 1 104 105 106 1 1 148 117 117 117 117 117 117 103 100 117 
117 117 117 151 148 117 135 1 1 1 120 121 122 1 1 132 117 117 117 118 151 149 148 151 148 117 117 117 151 148 117 135 1 1 1 120 121 122 1 1 132 117 117 117 118 151 149 148 151 148 117 117 117 151 148 117 135 1 1 1 120 121 122 1 1 132 117 117 117 118 151 149 148 151 148 117 117 117 151 148 117 135 1 1 1 120 121 122 1 1 132 117 117 117 118 151 149 148 151 148 
150 149 150 1 166 151 1 1 49 1 1 1 1 1 1 100 117 117 151 137 1 1 102 1 1 150 149 150 1 166 151 1 1 49 1 1 1 1 1 1 100 117 117 151 137 1 1 102 1 1 150 149 150 1 166 151 1 1 49 1 1 1 1 1 1 100 117 117 151 137 1 1 102 1 1 150 149 150 1 166 151 1 1 49 1 1 1 1 1 1 100 117 117 151 137 1 1 102 1 1 
1 1 1 1 116 103 1 1 1 1 1 1 1 1 100 133 134 117 136 151 49 100 118 164 1 1 1 1 1 116 103 1 1 1 1 1 1 1 1 100 133 134 117 136 151 49 100 118 164 1 1 1 1 1 116 103 1 1 1 1 1 1 1 1 100 133 134 117 136 151 49 100 118 164 1 1 1 1 1 116 103 1 1 1 1 1 1 1 1 100 133 134 117 136 151 49 100 118 164 1 
1 1 1 1 1 149 1 1 1 1 50 1 100 136 117 151 148 117 103 167 100 117 151 1 1 1 1 1 1 1 149 1 1 1 1 50 1 100 136 117 151 148 117 103 167 100 117 151 1 1 1 1 1 1 1 149 1 1 1 1 50 1 100 136 117 151 148 117 103 167 100 117 151 1 1 1 1 1 1 1 149 1 1 1 1 50 1 100 136 117 151 148 117 103 167 100 117 151 1 1 
1 1 1 1 1 1 1 101 102 1 1 132 151 1 149 1 1 148 117 117 151 149 1 1 1 1 1 1 1 1 1 1 101 102 1 1 132 151 1 149 1 1 148 117 117 151 149 1 1 1 1 1 1 1 1 1 1 101 102 1 1 132 151 1 149 1 1 148 117 117 151 149 1 1 1 1 1 1 1 1 1 1 101 102 1 1 132 151 1 149 1 1 148 117 117 151 149 1 1 1 
1 1 1 1 1 1 132 133 134 103 101 100 135 1 1 1 49 1 148 151 1 1 1 1 1 1 1 1 1 1 1 132 133 134 103 101 100 135 1 1 1 49 1 148 151 1 1 1 1 1 1 1 1 1 1 1 132 133 134 103 101 100 135 1 1 1 49 1 148 151 1 1 1 1 1 1 1 1 1 1 1 132 133 134 103 101 100 135 1 1 1 49 1 148 151 1 1 1 1 1 
1 50 1 1 116 103 100 117 117 117 117 151 1 1 1 1 1 1 1 1 1 1 1 1 1 1 50 1 1 116 103 100 117 117 117 117 151 1 1 1 1 1 1 1 1 1 1 1 1 1 1 50 1 1 116 103 100 117 117 117 117 151 1 1 1 1 1 1 1 1 1 1 1 1 1 1 50 1 1 116 103 100 117 117 117 117 151 1 1 1 1 1 1 1 1 1 1 1 1 1 
1 1 1 1 132 117 117 117 117 151 149 1 1 1 1 1 1 1 1 1 1 1 49 1 1 1 1 1 1 132 117 117 117 117 151 149 1 1 1 1 1 1 1 1 1 1 1 49 1 1 1 1 1 1 132 117 117 117 117 151 149 1 1 1 1 1 1 1 1 1 1 1 49 1 1 1 1 1 1 132 117 117 117 117 151 149 1 1 1 1 1 1 1 1 1 1 1 49 1 1 
1 1 1 1 100 117 117 117 151 1 1 1 50 1 1 1 1 1 1 1 1 1 1 1 1 1 1 1 1 100 117 117 117 151 1 1 1 50 1 1 1 1 1 1 1 1 1 1 1 1 1 1 1 1 100 117 117 117 151 1 1 1 50 1 1 1 1 1 1 1 1 1 1 1 1 1 1 1 1 100 117 117 117 151 1 1 1 50 1 1 1 1 1 1 1 1 1 1 1 1 
1 1 1 100 117 118 151 150 1 1 1 1 1 1 1 1 1 1 1 1 1 1 1 1 1 1 1 1 100 117 118 151 150 1 1 1 1 1 1 1 1 1 1 1 1 1 1 1 1 1 1 1 1 100 117 118 151 150 1 1 1 1 1 1 1 1 1 1 1 1 1 1 1 1 1 1 1 1 100 117 118 151 150 1 1 1 1 1 1 1 1 1 1 1 1 1 1 1 1 1 
1 1 1 149 148 117 103 132 135 1 1 1 50 1 1 1 1 1 1 1 1 1 1 1 1 1 1 1 149 148 117 103 132 135 1 1 1 50 1 1 1 1 1 1 1 1 1 1 1 1 1 1 1 149 148 117 103 132 135 1 1 1 50 1 1 1 1 1 1 1 1 1 1 1 1 1 1 1 149 148 117 103 132 135 1 1 1 50 1 1 1 1 1 1 1 1 1 1 1 1 
1 1 1 1 1 148 117 103 101 102 1 1 1 1 1 1 1 1 50 1 1 1 1 1 1 1 1 1 1 1 148 117 103 101 102 1 1 1 1 1 1 1 1 50 1 1 1 1 1 1 1 1 1 1 1 148 117 103 101 102 1 1 1 1 1 1 1 1 50 1 1 1 1 1 1 1 1 1 1 1 148 117 103 101 102 1 1 1 1 1 1 1 1 50 1 1 1 1 1 1 
1 49 1 1 1 1 165 148 117 117 103 101 1 1 1 101 1 1 1 1 1 49 1 1 1 1 49 1 1 1 1 165 148 117 117 103 101 1 1 1 101 1 1 1 1 1 49 1 1 1 1 49 1 1 1 1 165 148 117 117 103 101 1 1 1 101 1 1 1 1 1 49 1 1 1 1 49 1 1 1 1 165 148 117 117 103 101 1 1 1 101 1 1 1 1 1 49 1 1 1 
1 1 1 1 1 1 1 1 148 117 117 117 135 1 1 148 103 102 1 1 1 1 1 1 1 1 1 1 1 1 1 1 1 148 117 117 117 135 1 1 148 103 102 1 1 1 1 1 1 1 1 1 1 1 1 1 1 1 148 117 117 117 135 1 1 148 103 102 1 1 1 1 1 1 1 1 1 1 1 1 1 1 1 148 117 117 117 135 1 1 148 103 102 1 1 1 1 1 1 1 
1 1 1 1 1 1 1 1 100 117 117 117 103 167 101 100 118 117 103 102 1 1 1 1 1 1 1 1 1 1 1 1 1 100 117 117 117 103 167 101 100 118 117 103 102 1 1 1 1 1 1 1 1 1 1 1 1 1 100 117 117 117 103 167 101 100 118 117 103 102 1 1 1 1 1 1 1 1 1 1 1 1 1 100 117 117 117 103 167 101 100 118 117 103 102 1 1 1 1 1 
1 1 1 1 1 1 1 116 117 117 117 151 150 148 117 117 117 117 117 117 135 1 49 1 1 1 1 1 1 1 1 1 116 117 117 117 151 150 148 117 117 117 117 117 117 135 1 49 1 1 1 1 1 1 1 1 1 116 117 117 117 151 150 148 117 117 117 117 117 117 135 1 49 1 1 1 1 1 1 1 1 1 116 117 117 117 151 150 148 117 117 117 117 117 117 135 1 49 1 1 
1 1 50 1 1 100 103 166 117 151 150 1 49 1 148 117 151 148 117 117 103 1 1 1 1 1 1 50 1 1 100 103 166 117 151 150 1 49 1 148 117 151 148 117 117 103 1 1 1 1 1 1 50 1 1 100 103 166 117 151 150 1 49 1 148 117 151 148 117 117 103 1 1 1 1 1 1 50 1 1 100 103 166 117 151 150 1 49 1 148 117 151 148 117 117 103 1 1 1 1 
100 135 1 102 100 117 117 164 149 1 1 1 1 1 116 117 103 100 117 117 117 103 1 1 102 100 135 1 102 100 117 117 164 149 1 1 1 1 1 116 117 103 100 117 117 117 103 1 1 102 100 135 1 102 100 117 117 164 149 1 1 1 1 1 116 117 103 100 117 117 117 103 1 1 102 100 135 1 102 100 117 117 164 149 1 1 1 1 1 116 117 103 100 117 117 117 103 1 1 102 
117 103 100 117 117 117 151 1 1 1 104 105 106 1 1 148 117 117 117 117 117 117 103 100 117 117 103 100 117 117 117 151 1 1 1 104 105 106 1 1 148 117 117 117 117 117 117 103 100 117 117 103 100 117 117 117 151 1 1 1 104 105 106 1 1 148 117 117 117 117 117 117 103 100 117 117 103 100 117 117 117 151 1 1 1 104 105 106 1 1 148 117 117 117 117 117 117 103 100 117 
117 117 117 151 148 117 135 1 1 1 120 121 122 1 1 132 117 117 117 118 151 149 148 151 148 117 117 117 151 148 117 135 1 1 1 120 121 122 1 1 132 117 117 117 118 151 149 148 151 148 117 117 117 151 148 117 135 1 1 1 120 121 122 1 1 132 117 117 117 118 151 149 148 151 148 117 117 117 151 148 117 135 1 1 1 120 121 122 1 1 132 117 117 117 118 151 149 148 151 148 
150 149 150 1 166 151 1 1 49 1 1 1 1 1 1 100 117 117 151 137 1 1 102 1 1 150 149 150 1 166 151 1 1 49 1 1 1 1 1 1 100 117 117 151 137 1 1 102 1 1 150 149 150 1 166 151 1 1 49 1 1 1 1 1 1 100 117 117 151 137 1 1 102 1 1 150 149 150 1 166 151 1 1 49 1 1 1 1 1 1 100 117 117 151 137 1 1 102 1 1 
1 1 1 1 116 103 1 1 1 1 1 1 1 1 100 133 134 117 136 151 49 100 118 164 1 1 1 1 1 116 103 1 1 1 1 1 1 1 1 100 133 134 117 136 151 49 100 118 164 1 1 1 1 1 116 103 1 1 1 1 1 1 1 1 100 133 134 117 136 151 49 100 118 164 1 1 1 1 1 116 103 1 1 1 1 1 1 1 1 100 133 134 117 136 151 49 100 118 164 1 
1 1 1 1 1 149 1 1 1 1 50 1 100 136 117 151 148 117 103 167 100 117 151 1 1 1 1 1 1 1 149 1 1 1 1 50 1 100 136 117 151 148 117 103 167 100 117 151 1 1 1 1 1 1 1 149 1 1 1 1 50 1 100 136 117 151 148 117 103 167 100 117 151 1 1 1 1 1 1 1 149 1 1 1 1 50 1 100 136 117 151 148 117 103 167 100 117 151 1 1 
1 1 1 1 1 1 1 101 102 1 1 132 151 1 149 1 1 148 117 117 151 149 1 1 1 1 1 1 1 1 1 1 101 102 1 1 132 151 1 149 1 1 148 117 117 151 149 1 1 1 1 1 1 1 1 1 1 101 102 1 1 132 151 1 149 1 1 148 117 117 151 149 1 1 1 1 1 1 1 1 1 1 101 102 1 1 132 151 1 149 1 1 148 117 117 151 149 1 1 1 
1 1 1 1 1 1 132 133 134 103 101 100 135 1 1 1 49 1 148 151 1 1 1 1 1 1 1 1 1 1 1 132 133 134 103 101 100 135 1 1 1 49 1 148 151 1 1 1 1 1 1 1 1 1 1 1 132 133 134 103 101 100 135 1 1 1 49 1 148 151 1 1 1 1 1 1 1 1 1 1 1 132 133 134 103 101 100 135 1 1 1 49 1 148 151 1 1 1 1 1 
1 50 1 1 116 103 100 117 117 117 117 151 1 1 1 1 1 1 1 1 1 1 1 1 1 1 50 1 1 116 103 100 117 117 117 117 151 1 1 1 1 1 1 1 1 1 1 1 1 1 1 50 1 1 116 103 100 117 117 117 117 151 1 1 1 1 1 1 1 1 1 1 1 1 1 1 50 1 1 116 103 100 117 117 117 117 151 1 1 1 1 1 1 1 1 1 1 1 1 1 
1 1 1 1 132 117 117 117 117 151 149 1 1 1 1 1 1 1 1 1 1 1 49 1 1 1 1 1 1 132 117 117 117 117 151 149 1 1 1 1 1 1 1 1 1 1 1 49 1 1 1 1 1 1 132 117 117 117 117 151 149 1 1 1 1 1 1 1 1 1 1 1 49 1 1 1 1 1 1 132 117 117 117 117 151 149 1 1 1 1 1 1 1 1 1 1 1 49 1 1 
1 1 1 1 100 117 117 117 151 1 1 1 50 1 1 1 1 1 1 1 1 1 1 1 1 1 1 1 1 100 117 117 117 151 1 1 1 50 1 1 1 1 1 1 1 1 1 1 1 1 1 1 1 1 100 117 117 117 151 1 1 1 50 1 1 1 1 1 1 1 1 1 1 1 1 1 1 1 1 100 117 117 117 151 1 1 1 50 1 1 1 1 1 1 1 1 1 1 1 1 
1 1 1 100 117 118 151 150 1 1 1 1 1 1 1 1 1 1 1 1 1 1 1 1 1 1 1 1 100 117 118 151 150 1 1 1 1 1 1 1 1 1 1 1 1 1 1 1 1 1 1 1 1 100 117 118 151 150 1 1 1 1 1 1 1 1 1 1 1 1 1 1 1 1 1 1 1 1 100 117 118 151 150 1 1 1 1 1 1 1 1 1 1 1 1 1 1 1 1 1 
