1 1 1 1 1 1 1 1 1 1 1 1 1 1 1 1 1 1 1 1 1 1 1 1 1 
1 1 1 1 1 1 1 1 1 1 1 1 1 1 1 1 1 1 1 1 1 1 1 1 1 
1 1 1 1 1 1 1 1 1 1 1 1 1 1 1 177 178 179 1 1 1 177 178 179 1 
1 1 1 1 1 1 1 1 1 1 1 1 1 1 1 1 1 1 197 196 197 1 1 1 1 
1 1 106 108 109 110 111 1 1 1 1 1 1 1 1 1 1 1 1 1 1 1 1 1 1 
1 1 122 124 126 126 127 1 1 1 1 1 1 1 1 1 1 1 1 1 1 1 1 1 1 
1 1 138 139 142 142 143 1 1 1 1 1 1 1 1 1 1 1 1 1 1 1 1 1 1 
1 1 1 1 1 1 1 1 1 1 1 1 1 1 1 1 1 1 1 1 1 1 1 1 1 
1 1 1 1 1 1 1 1 1 1 1 1 1 1 1 1 1 1 1 1 1 1 1 1 1 
1 1 1 1 1 1 1 1 1 1 1 1 1 1 1 177 178 179 1 1 1 177 178 179 1 
1 1 170 172 173 175 1 1 1 1 1 1 1 1 1 193 194 195 197 196 197 1 1 1 1 
1 1 186 188 189 191 1 1 1 1 1 1 1 1 1 1 1 1 1 1 1 1 1 1 1 
1 1 202 203 206 207 1 1 1 1 1 1 1 1 1 1 1 1 1 1 1 1 1 1 1 
1 1 1 1 1 1 1 1 1 1 1 1 1 1 1 1 1 1 1 1 1 1 1 1 1 
1 1 1 1 1 1 1 1 1 1 1 1 1 1 1 1 1 1 1 1 1 1 1 1 1 
1 1 1 1 1 1 1 1 1 1 1 1 1 1 1 1 1 1 1 1 1 1 1 1 1 
1 1 1 1 1 1 1 1 1 1 1 1 1 1 1 1 1 1 1 1 1 1 1 1 1 
1 1 1 1 1 1 1 1 1 1 1 1 1 1 1 1 1 1 1 1 1 1 1 1 1 
1 1 1 1 1 1 1 1 1 1 1 1 1 1 1 1 1 1 1 1 1 1 1 1 1 
