116 116 116 102 116 116 118 102 121 121 137 121 105 116 119 116 116 102 116 116 116 102 116 102 151 
116 116 102 102 116 102 118 116 105 120 137 120 121 102 119 116 102 102 116 116 102 102 102 116 151 
116 102 116 116 116 102 118 102 121 121 137 121 105 102 119 116 102 116 102 116 102 116 116 116 151 
153 153 153 153 153 153 135 134 136 153 153 153 135 134 136 193 181 195 153 153 153 193 181 195 151 
131 1 1 1 1 1 1 1 1 1 1 1 1 1 1 119 151 118 132 148 133 119 151 118 151 
147 1 1 1 1 1 1 1 1 129 130 130 131 1 1 119 151 211 133 133 146 209 151 118 151 
147 1 138 139 142 142 143 1 1 145 148 132 147 1 1 209 151 133 133 148 132 133 151 211 151 
147 1 154 155 158 158 159 1 1 145 148 132 147 1 129 146 151 148 132 148 132 133 151 133 151 
132 130 130 130 130 130 130 130 130 148 132 148 163 1 161 162 151 133 133 132 133 133 151 132 151 
148 133 162 162 162 162 162 162 148 132 133 147 1 1 1 1 151 148 133 133 148 148 151 163 151 
148 147 1 1 1 1 1 1 145 148 148 147 1 1 1 193 194 195 132 132 132 193 194 195 151 
133 147 1 1 1 1 1 129 148 148 132 147 1 1 1 119 116 118 121 137 121 119 102 118 151 
133 147 202 203 206 207 1 161 133 133 132 146 131 1 1 119 102 118 105 137 105 119 116 118 151 
148 147 218 222 222 223 1 1 145 148 133 148 133 130 130 209 210 211 121 137 121 209 102 211 151 
148 133 130 130 130 130 130 130 146 133 146 162 132 148 162 146 148 148 148 148 148 148 146 163 151 
162 162 162 162 162 162 162 162 162 162 163 1 161 163 1 161 162 162 146 132 132 148 163 1 102 
1 1 1 1 1 1 1 1 1 1 1 1 1 1 1 1 1 1 161 162 162 163 1 1 116 
115 1 115 1 115 1 115 1 115 1 115 1 115 1 115 1 115 1 115 1 115 1 115 129 102 
114 114 114 114 114 114 114 114 114 114 114 114 114 114 114 114 114 114 114 114 114 114 114 114 114 
