90 93 94 50 1 1 1 1 1 1 1 1 1 1 1 1 1 1 1 69 2 1 1 1 1 
1 1 1 1 1 1 1 1 50 1 1 1 1 1 1 1 1 1 1 69 18 1 1 50 1 
1 1 1 1 1 1 1 1 1 1 1 1 49 1 1 1 49 1 1 69 2 1 49 1 1 
1 1 1 1 1 1 49 1 1 1 1 1 1 1 1 1 1 1 1 69 18 1 1 1 1 
1 1 1 49 1 1 1 1 1 1 1 1 1 1 1 1 49 1 1 69 2 1 1 1 1 
50 1 1 1 1 1 1 50 1 1 1 1 49 1 1 1 1 1 1 69 18 1 1 1 1 
1 1 1 1 1 1 1 1 1 1 1 1 1 1 1 1 1 1 53 83 84 1 1 1 1 
1 1 49 1 1 1 1 1 1 1 1 49 1 1 50 1 1 1 69 18 1 1 1 50 1 
1 1 1 1 1 1 1 1 1 1 1 1 1 1 1 1 1 1 69 2 1 50 1 1 1 
1 1 1 1 1 1 1 1 1 1 1 1 1 1 1 50 1 1 69 18 1 1 1 1 1 
1 1 1 1 50 1 1 1 49 50 1 1 1 1 1 1 1 1 69 2 1 1 1 50 1 
1 1 49 1 1 1 1 1 1 1 1 1 1 1 1 49 1 53 83 84 1 50 1 1 1 
50 1 1 1 1 1 1 50 1 1 1 1 1 1 1 1 1 69 18 1 1 1 1 1 1 
1 1 1 1 1 1 1 1 1 1 1 1 1 53 83 84 83 83 84 1 1 1 1 50 1 
83 83 83 83 83 83 83 83 83 83 83 83 83 83 84 1 1 1 1 1 1 50 1 1 1 
1 1 1 1 1 1 1 1 1 1 1 1 1 1 1 1 1 50 1 1 1 1 49 1 1 
9 9 9 10 9 10 9 10 9 10 9 10 9 9 10 9 9 10 9 10 9 10 9 10 9 
24 39 24 41 24 39 24 24 24 39 24 42 43 44 24 24 39 24 24 41 24 24 39 24 24 
62 55 56 57 62 55 56 24 62 55 56 58 75 60 61 62 55 56 24 57 24 62 55 56 24 
