103 103 103 103 103 103 103 103 103 103 103 103 103 103 103 103 103 103 103 103 103 103 103 103 103 
103 103 103 103 103 103 103 103 103 103 103 103 103 103 103 103 103 103 103 103 103 103 103 103 103 
103 103 103 103 103 103 103 103 103 103 103 103 103 103 103 103 103 103 103 103 103 103 103 103 103 
103 103 103 103 103 103 103 103 103 103 103 103 103 103 103 103 103 103 103 103 103 103 103 103 103 
103 103 103 103 103 103 103 103 103 103 103 103 103 103 103 103 103 103 103 103 103 103 103 103 103 
103 103 103 103 103 103 103 103 103 103 103 103 103 103 103 103 103 103 103 103 103 103 103 103 103 
103 103 103 103 103 103 103 103 103 103 103 136 137 138 103 103 103 103 103 103 103 103 103 103 103 
103 103 103 103 103 103 103 103 103 103 136 137 1 1 138 103 103 103 103 103 103 103 103 103 103 
103 103 103 103 103 103 103 103 103 136 137 113 1 113 1 138 103 103 103 103 103 103 103 103 103 
103 103 103 103 103 103 103 103 136 137 1 1 1 1 1 135 103 103 103 103 103 103 103 103 103 
103 103 103 103 103 103 103 103 105 1 11 1 1 113 1 104 103 103 103 103 103 103 103 103 103 
103 103 103 103 103 103 103 103 121 1 113 1 1 1 1 120 103 103 103 103 103 103 103 103 103 
103 103 103 103 103 103 103 136 137 1 1 1 1 1 1 138 103 103 103 103 103 103 103 103 103 
103 103 103 103 103 103 103 139 140 1 1 1 113 1 11 135 103 103 103 103 103 103 103 103 103 
103 103 103 103 103 103 103 103 105 1 113 1 1 113 1 104 103 103 103 103 103 103 103 103 103 
103 103 103 103 103 103 103 103 103 140 1 11 113 1 1 120 103 103 103 103 103 103 103 103 103 
103 103 103 103 103 103 103 103 103 139 99 100 101 102 135 103 103 103 103 103 103 103 103 103 103 
97 97 97 97 97 97 97 97 97 97 97 116 117 97 97 97 97 97 97 97 97 97 97 97 97 
97 97 97 97 97 97 97 97 97 97 97 97 97 97 97 97 97 97 97 97 97 97 97 97 97 
