1 1 1 1 1 1 1 1 1 1 1 1 1 1 1 1 1 1 1 1 1 1 1 1 1 
1 1 1 1 1 1 1 1 1 1 1 1 1 1 1 1 1 1 1 1 1 1 1 1 1 
1 1 1 1 1 1 1 1 1 1 1 1 1 1 1 1 1 1 1 1 1 1 1 1 1 
1 1 1 1 1 1 1 1 1 1 1 1 1 1 1 1 1 1 1 1 1 1 1 1 1 
1 1 1 1 1 1 1 1 1 1 1 1 1 1 1 1 1 1 1 1 1 1 1 1 1 
1 1 1 1 1 1 1 1 1 1 1 1 1 1 1 1 1 1 1 1 1 1 1 1 1 
1 1 1 1 1 1 1 1 1 1 1 1 1 1 1 1 1 1 1 1 1 1 1 1 1 
1 1 1 1 1 1 1 1 1 1 1 1 1 1 1 1 1 1 1 1 1 1 1 1 1 
1 1 1 1 1 2 14 15 3 3 3 3 3 3 3 6 7 11 1 1 1 1 1 1 1 
1 1 1 1 1 18 30 31 3 3 3 4 3 3 3 22 23 27 1 1 1 1 1 1 1 
1 1 1 1 1 34 46 47 36 36 37 37 37 37 37 38 39 43 1 1 1 1 1 1 1 
1 1 1 1 1 50 62 63 52 52 52 52 52 52 52 54 55 59 1 1 1 1 1 1 1 
1 1 1 1 1 66 53 83 84 53 53 53 83 84 53 53 53 75 1 1 1 1 1 1 1 
1 1 1 1 1 82 53 53 53 99 100 53 53 53 53 53 53 91 1 1 1 1 1 1 1 
1 1 1 1 1 98 89 90 53 53 53 53 53 53 53 67 68 107 1 1 1 1 1 1 1 
1 1 1 1 1 113 114 114 115 1 1 1 1 1 1 1 1 1 1 1 1 1 1 1 1 
1 1 1 1 1 1 1 1 1 1 1 1 1 1 1 1 1 1 1 1 1 1 1 1 1 
1 1 1 1 1 1 1 1 1 1 1 1 1 1 1 1 1 1 1 1 1 1 1 1 1 
1 1 1 1 1 1 1 1 1 1 1 1 1 1 1 1 1 1 1 1 1 1 1 1 1 
