103 103 103 103 103 103 103 103 103 103 103 103 103 103 103 103 103 103 103 103 103 103 103 103 103 
103 103 103 103 103 103 103 103 103 103 103 103 103 103 103 103 103 103 103 103 103 103 103 103 103 
103 103 103 103 103 103 103 103 62 63 63 63 63 63 63 64 103 103 103 103 103 103 103 103 103 
103 103 103 103 103 103 103 103 30 31 31 31 31 31 31 32 103 103 103 103 103 103 103 103 103 
103 103 103 103 103 103 103 103 46 47 47 47 47 47 47 48 138 103 103 103 103 103 103 103 103 
103 103 103 103 103 103 103 62 64 1 1 113 1 1 1 62 64 104 103 103 103 103 103 103 103 
103 103 103 103 103 103 103 30 32 1 113 1 1 113 1 30 32 120 103 103 103 103 103 103 103 
103 103 103 103 103 103 103 46 48 113 113 1 113 1 11 46 48 104 103 103 103 103 103 103 103 
103 103 103 103 103 103 103 62 63 64 1 11 1 1 62 63 64 120 103 103 103 103 103 103 103 
103 103 103 103 103 103 103 30 31 32 1 1 113 1 30 31 32 104 103 103 103 103 103 103 103 
103 103 103 103 103 103 103 46 47 48 1 113 1 1 46 47 48 120 103 103 103 103 103 103 103 
103 103 103 103 103 103 103 62 63 64 1 113 1 1 62 63 64 104 103 103 103 103 103 103 103 
103 103 103 103 103 103 103 30 31 32 113 1 113 1 30 31 32 120 103 103 103 103 103 103 103 
103 103 103 103 103 103 103 46 47 48 113 1 113 113 46 47 48 104 103 103 103 103 103 103 103 
103 103 103 103 103 103 103 62 63 64 1 1 1 1 62 63 64 120 103 103 103 103 103 103 103 
103 103 103 103 103 103 103 30 31 80 11 113 113 1 30 31 32 104 103 103 103 103 103 103 103 
103 103 103 103 103 103 103 46 47 48 99 100 101 102 46 47 48 120 103 103 103 103 103 103 103 
97 97 97 97 97 97 97 97 97 97 97 116 117 97 97 97 97 97 97 97 97 97 97 97 97 
97 97 97 97 97 97 97 97 97 97 97 97 97 97 97 97 97 97 97 97 97 97 97 97 97 
