113 114 115 1 1 1 1 1 1 1 1 1 1 1 1 1 1 1 1 1 1 1 1 1 1 
129 130 131 1 1 1 1 1 1 1 1 1 1 1 1 1 1 1 1 1 1 1 51 1 1 
145 146 147 51 1 1 1 1 1 1 1 1 1 1 1 1 1 1 181 1 1 1 1 1 51 
161 162 163 1 1 1 1 1 1 1 1 1 1 1 1 1 1 1 1 1 1 1 1 1 1 
177 178 179 1 1 1 1 1 1 1 1 1 1 1 1 1 1 1 1 1 1 1 1 1 1 
1 98 1 1 1 1 1 1 1 1 1 1 1 1 1 1 1 1 1 1 1 1 1 1 1 
113 114 115 51 1 1 1 1 1 1 1 1 1 1 1 1 1 1 1 1 1 1 1 1 1 
129 130 131 1 1 1 1 1 1 1 1 1 1 1 1 1 1 1 1 1 1 1 1 1 1 
145 146 147 1 1 1 1 1 1 1 1 181 1 1 1 1 1 1 1 1 1 1 1 1 1 
161 162 163 1 1 1 1 1 1 1 1 1 1 1 1 1 1 1 1 1 1 1 1 1 1 
177 178 179 1 1 1 1 1 1 1 1 1 1 1 1 1 1 1 1 1 1 1 1 1 1 
1 98 1 1 1 1 1 1 1 1 1 1 1 1 1 1 1 1 1 1 1 1 1 1 1 
113 114 115 1 1 1 1 1 1 1 1 1 1 1 1 1 1 1 1 1 1 33 35 35 35 
129 130 131 1 1 1 1 1 1 1 1 1 1 1 1 1 1 1 1 1 33 84 51 1 1 
145 130 147 1 1 1 1 1 1 1 1 1 1 1 1 1 1 33 35 35 84 1 1 51 1 
161 162 163 1 1 1 1 1 1 1 1 1 1 1 1 1 33 84 1 1 1 1 51 1 1 
177 178 179 83 34 34 35 34 35 34 34 34 34 34 35 34 84 51 1 1 1 1 1 1 1 
1 1 1 1 1 1 1 1 52 1 1 1 1 1 51 1 1 1 1 1 1 1 1 1 1 
1 1 1 1 51 1 1 1 1 1 1 1 1 1 1 1 1 1 1 1 1 1 1 1 1 
