49 1 50 19 14 15 62 55 56 24 58 25 60 61 62 55 56 24 58 63 60 18 1 1 50 
1 1 1 3 30 31 25 25 72 73 74 75 25 25 25 76 72 73 74 79 25 2 1 49 1 
1 1 49 19 46 47 89 90 87 88 89 90 87 88 89 90 87 88 89 90 87 18 49 50 1 
1 1 1 3 78 50 102 1 1 1 1 1 1 1 1 1 1 196 197 198 69 8 9 10 9 
1 1 1 19 78 166 118 135 1 1 49 1 1 1 1 49 1 1 1 1 69 22 39 24 41 
193 194 195 3 78 1 137 1 1 1 1 1 49 1 1 1 49 1 1 50 69 54 55 56 57 
1 1 49 19 78 1 137 1 1 50 1 1 1 1 1 1 1 1 1 1 69 70 75 72 73 
49 49 1 3 78 1 137 1 49 1 1 1 1 1 1 104 105 106 1 1 85 86 87 88 89 
1 1 49 19 78 1 137 1 1 1 1 1 49 50 1 120 121 122 1 50 1 1 102 101 101 
1 1 1 3 78 132 117 103 102 1 196 197 198 1 1 101 101 102 101 101 101 100 117 117 118 
1 1 1 19 78 116 118 117 117 135 50 1 1 1 116 117 118 117 117 133 134 117 118 117 117 
193 194 195 3 78 49 148 133 134 103 101 101 101 101 100 117 117 117 118 117 151 150 149 150 150 
49 1 50 19 78 1 116 117 117 118 117 117 117 117 118 117 151 150 150 149 1 81 81 81 81 
1 1 1 19 78 1 1 148 117 117 118 117 133 134 151 149 1 1 50 1 81 1 1 1 1 
1 1 1 19 78 1 1 1 149 149 165 150 150 149 1 49 1 81 81 81 81 1 1 1 1 
1 1 1 3 78 50 1 1 1 49 1 1 1 1 50 1 81 81 1 1 1 1 1 1 1 
1 49 1 81 81 81 81 81 81 81 81 81 81 81 81 81 81 1 1 10 10 10 10 10 10 
193 194 195 50 1 1 49 1 1 1 1 1 1 1 1 1 1 1 11 24 39 24 41 42 43 
49 1 1 1 1 1 49 1 1 1 1 1 1 1 49 1 1 11 77 62 55 56 57 58 25 
