1 19 25 25 25 21 87 88 20 25 21 87 88 89 20 25 21 87 88 89 90 20 25 25 2 
1 3 25 25 25 5 68 53 4 25 5 68 49 53 4 25 5 68 148 103 53 4 25 25 18 
1 19 25 25 25 21 78 69 20 25 21 78 1 69 20 25 21 78 49 137 69 20 25 25 2 
81 11 25 25 25 5 78 69 4 25 5 78 1 69 4 25 5 78 116 151 69 4 25 25 18 
3 5 25 25 25 21 78 69 20 25 21 78 1 69 20 25 21 78 116 119 69 20 25 25 2 
3 21 25 25 25 77 78 69 70 25 77 78 50 69 70 25 77 78 116 103 69 70 25 25 18 
19 5 87 88 89 93 94 85 86 87 93 94 1 85 86 87 93 94 1 165 85 86 87 88 2 
19 21 68 1 1 1 1 1 1 1 1 1 1 1 1 1 1 1 100 164 1 1 1 53 8 
19 5 78 49 1 1 1 1 50 1 49 1 1 1 1 101 166 136 118 135 1 50 1 69 22 
19 21 78 1 1 1 1 1 1 1 1 1 1 102 100 118 103 116 117 119 1 1 1 69 22 
19 5 78 1 1 49 1 50 1 1 102 101 100 133 134 117 151 100 151 1 1 50 1 69 22 
19 21 78 1 1 1 1 102 101 100 117 25 25 25 25 25 25 117 119 1 1 1 1 69 22 
19 77 78 1 1 1 100 117 117 118 117 151 149 137 100 103 116 151 1 1 1 1 1 69 22 
19 93 94 1 1 116 117 117 117 117 151 116 136 118 117 117 164 1 1 49 1 1 50 69 22 
19 68 1 50 1 100 117 118 151 137 100 103 116 117 151 149 1 1 1 1 1 1 1 69 22 
19 78 49 1 100 117 151 165 100 117 117 117 135 149 1 1 1 1 1 50 1 1 1 69 22 
19 25 25 25 25 25 25 25 25 117 151 149 1 25 25 1 50 1 25 25 1 1 25 25 22 
19 25 25 25 25 25 25 25 25 151 1 50 1 25 25 1 1 1 25 25 1 1 25 25 22 
19 25 25 25 25 25 25 25 25 25 25 25 25 25 25 25 25 25 25 25 25 25 25 25 22 
