1 81 10 10 10 9 10 9 10 9 10 9 9 10 9 10 9 10 9 9 10 9 10 82 19 1 1 1 1 1 1 50 1 81 9 10 9 9 10 9 10 9 11 78 69 8 9 9 11 78 1 1 1 1 1 1 1 1 1 1 1 50 1 1 1 1 1 1 1 1 1 1 1 50 1 1 1 1 1 1 1 1 1 50 1 1 1 1 1 1 1 1 1 1 1 1 1 1 1 1 
1 19 56 24 58 76 60 61 62 55 56 24 58 25 60 61 62 55 56 24 58 63 25 18 3 1 1 1 1 1 1 1 1 19 87 88 89 90 87 88 89 90 93 94 85 86 87 90 93 94 1 1 50 1 1 1 1 1 1 1 1 1 1 1 1 1 1 50 1 1 1 1 1 1 1 1 1 50 1 1 1 1 1 1 1 1 1 1 1 1 1 1 1 1 1 1 1 1 50 1 
1 19 72 73 74 25 25 75 25 25 72 73 74 25 25 25 25 25 72 73 74 79 25 18 19 1 1 1 50 1 1 50 1 3 68 49 1 1 1 1 1 1 1 1 1 1 49 1 1 1 1 1 1 1 1 1 1 1 1 1 1 1 1 1 1 1 1 1 1 1 1 49 1 50 1 1 1 1 1 1 1 1 1 1 50 1 1 1 1 1 50 1 1 1 50 1 1 1 1 1 
1 3 90 87 88 89 90 87 88 89 90 87 88 89 90 87 88 89 90 87 88 89 90 18 3 1 50 1 1 50 1 1 1 19 78 1 1 1 1 1 49 1 1 1 1 1 1 1 49 1 1 1 1 1 49 1 1 1 1 1 1 1 1 1 1 1 1 49 1 1 1 1 1 1 1 1 49 1 53 18 84 84 19 68 1 1 1 1 1 1 1 1 1 1 50 1 49 1 1 1 
1 19 1 1 1 1 1 1 1 1 1 1 1 1 1 1 1 1 1 1 1 1 69 18 19 1 1 1 50 1 1 1 50 3 78 49 1 1 1 1 1 1 1 1 1 50 50 1 1 1 1 1 49 1 1 1 1 1 1 1 1 1 1 1 1 50 1 1 1 1 1 1 50 1 50 1 1 1 69 8 9 9 11 78 1 1 1 49 1 1 1 1 1 1 1 1 1 1 1 1 
1 19 1 1 1 1 1 1 1 1 1 1 1 1 1 1 1 1 1 1 1 1 69 18 3 1 1 1 1 1 1 1 1 19 78 1 1 1 1 50 1 50 1 1 1 1 1 50 1 1 1 1 1 49 50 1 53 28 44 24 24 39 7 68 50 1 1 1 49 1 1 1 1 1 1 1 1 1 85 86 87 88 93 94 1 1 50 1 1 1 1 1 1 1 1 1 1 1 1 1 
49 3 1 1 1 1 1 1 1 1 1 1 1 1 1 1 1 1 1 1 1 1 69 18 19 1 50 1 1 1 1 50 1 3 78 1 1 1 1 1 1 1 1 1 1 1 1 1 1 1 1 1 1 1 1 1 69 20 60 61 62 55 12 78 1 1 50 1 1 1 1 1 1 1 1 1 1 1 1 1 1 1 1 1 1 1 1 1 1 1 1 53 18 84 84 19 68 1 1 1 
1 19 1 1 1 1 1 1 1 1 1 1 1 1 1 1 1 1 1 1 1 1 69 8 11 1 1 1 81 10 10 10 10 11 78 1 1 1 1 1 1 1 1 1 1 1 1 1 1 1 1 1 1 1 1 1 69 70 75 25 25 76 77 78 50 1 1 1 1 1 1 49 1 1 1 1 1 1 1 1 1 1 1 50 1 1 1 49 1 1 1 69 8 9 9 11 78 49 1 1 
1 3 1 53 18 3 30 31 25 25 72 73 74 25 25 25 25 25 18 3 68 1 69 22 7 1 1 1 19 88 88 89 90 93 94 1 1 49 1 1 1 50 1 1 1 1 1 1 1 1 1 1 1 1 49 1 85 86 87 88 89 90 93 94 1 1 1 1 1 1 1 1 1 1 1 1 1 1 1 1 1 49 1 1 1 1 1 1 1 1 1 85 86 87 88 93 94 1 1 1 
1 19 1 69 18 19 46 47 87 88 89 90 87 88 89 90 87 88 18 3 78 1 69 6 23 1 1 1 19 68 1 1 1 1 1 1 1 1 1 1 1 1 1 50 49 1 1 1 50 1 1 1 1 1 1 1 1 1 1 1 1 1 1 50 1 1 1 49 1 1 49 1 1 1 50 1 1 50 1 1 1 1 1 1 1 1 1 1 1 1 1 1 1 1 1 1 1 1 1 1 
1 19 1 69 2 3 68 1 1 1 1 1 1 1 1 1 1 1 2 19 78 1 69 54 24 1 50 1 3 78 1 50 1 1 50 49 1 1 1 50 1 1 1 1 1 1 1 1 1 1 1 50 1 50 1 1 1 1 1 1 1 1 1 1 1 1 1 1 1 1 1 1 1 1 1 1 1 1 1 1 1 1 1 1 1 1 1 1 50 1 1 1 1 1 1 1 50 1 50 1 
1 3 1 69 18 83 78 82 82 82 82 82 82 82 82 82 1 1 18 3 78 1 69 8 9 10 10 82 19 78 1 81 81 1 1 1 1 1 1 1 1 1 49 1 1 1 50 1 1 1 1 1 1 1 1 50 1 1 1 1 1 1 1 1 1 1 1 1 1 1 1 1 1 1 1 1 49 1 1 1 53 18 84 84 19 68 50 1 1 1 1 1 49 1 1 1 1 1 1 1 
1 3 1 69 8 9 1 1 1 1 1 1 1 1 1 1 1 1 2 3 78 1 85 86 88 89 90 8 11 78 53 18 19 68 1 1 1 50 1 1 50 1 1 1 1 1 50 1 50 1 1 1 1 1 1 1 1 1 49 1 50 1 1 1 53 8 9 10 11 68 1 1 1 49 1 1 1 1 1 50 69 8 9 10 11 78 1 1 104 105 106 1 1 1 1 1 1 1 1 1 
1 19 1 69 22 39 1 1 1 1 1 1 1 1 1 1 1 1 18 19 78 1 1 1 1 1 85 86 93 94 69 18 3 78 1 1 1 1 1 1 1 1 1 50 1 1 1 1 1 1 1 1 1 50 1 1 1 1 1 1 1 1 1 1 85 86 87 88 93 94 1 1 1 1 1 1 1 1 1 1 85 86 87 88 93 94 1 1 120 121 122 1 1 53 18 84 84 19 68 1 
1 3 1 69 54 55 1 1 1 1 1 1 1 1 1 1 1 1 2 3 78 1 1 1 1 50 1 1 1 1 69 18 19 78 1 1 1 1 1 1 1 1 1 1 1 1 1 1 1 1 1 1 1 1 1 1 1 1 1 49 1 1 1 1 1 1 1 1 1 1 49 1 1 1 1 1 1 50 1 1 1 1 1 1 1 50 1 1 1 1 1 50 1 69 8 9 10 11 78 1 
1 19 1 69 70 25 72 73 74 79 25 25 25 25 75 77 68 1 2 19 78 1 1 1 1 1 50 1 1 50 69 2 3 78 49 1 1 1 1 1 1 1 1 1 1 1 1 1 1 1 1 1 1 1 1 1 1 1 1 1 1 1 1 50 1 1 50 1 1 1 1 1 1 1 1 1 1 1 1 50 1 1 1 1 1 1 1 1 1 1 1 1 1 85 86 89 90 93 94 1 
1 19 1 85 86 87 88 87 88 89 90 87 88 89 90 93 94 1 2 83 81 81 81 81 81 81 81 1 1 1 69 18 19 78 1 1 1 1 49 1 1 1 1 50 1 1 1 53 22 39 39 7 68 1 1 1 1 1 1 1 1 1 1 1 1 1 1 1 1 1 1 50 1 1 50 50 1 50 1 1 1 1 1 49 1 1 1 50 1 1 50 1 50 1 1 1 1 1 1 1 
50 19 1 1 1 1 1 1 1 1 1 1 1 1 1 1 1 1 18 1 1 1 1 1 1 1 3 68 1 50 69 18 3 78 1 1 50 1 1 1 50 1 1 1 1 1 1 69 54 55 55 12 78 1 1 1 50 1 1 1 50 1 1 1 1 49 1 1 1 1 1 1 1 1 1 1 1 1 1 1 50 1 1 1 1 1 1 49 1 1 1 1 1 1 1 1 1 1 1 81 
1 83 81 81 81 81 81 81 81 81 81 81 81 81 81 81 81 81 84 1 1 1 1 1 1 1 83 81 81 81 81 84 19 78 1 1 1 1 1 1 1 1 1 1 1 1 1 69 70 25 75 77 78 1 1 1 1 1 1 1 1 1 1 1 1 1 1 1 1 53 81 81 81 81 81 81 81 81 81 81 81 81 81 68 1 50 1 53 81 81 81 81 81 81 81 81 81 81 81 81 
49 1 50 19 14 15 62 55 56 24 58 25 60 61 62 55 56 24 58 63 60 18 1 1 50 1 1 1 1 49 1 1 19 78 1 1 1 1 1 1 1 1 1 1 1 50 1 85 86 87 90 93 94 50 1 1 1 1 1 1 1 1 1 1 1 1 1 1 1 69 2 1 1 1 1 
1 1 1 3 30 31 25 25 72 73 74 75 25 25 25 76 72 73 74 79 25 2 1 49 1 1 1 50 1 1 1 1 3 78 1 1 50 1 1 50 1 1 1 1 1 1 1 1 1 1 1 1 1 1 1 1 1 1 50 1 1 1 1 1 1 1 1 1 1 69 18 1 1 50 1 
1 1 49 19 46 47 89 90 87 88 89 90 87 88 89 90 87 88 89 90 87 18 49 50 1 1 1 1 1 49 1 49 19 78 1 1 1 1 1 1 1 1 1 50 1 1 1 1 50 1 1 1 1 1 1 1 1 1 1 1 1 1 49 1 1 1 49 1 1 69 2 1 49 1 1 
1 1 1 3 78 50 102 1 1 1 1 1 1 1 1 1 1 196 197 198 69 8 9 10 9 10 10 9 9 82 81 10 11 78 1 1 1 1 1 1 1 1 1 1 1 1 1 1 1 1 1 1 1 1 1 1 49 1 1 1 1 1 1 1 1 1 1 1 1 69 18 1 1 1 1 
1 1 1 19 78 166 118 135 1 1 49 1 1 1 1 49 1 1 1 1 69 22 39 24 41 24 24 24 41 2 3 39 23 78 1 1 1 1 1 50 1 1 50 1 50 1 1 1 1 1 1 1 1 49 1 1 1 1 1 1 1 1 1 1 1 1 49 1 1 69 2 1 1 1 1 
193 194 195 3 78 1 137 1 1 1 1 1 49 1 1 1 49 1 1 50 69 54 55 56 57 42 43 44 57 18 19 55 12 78 50 1 1 50 1 1 1 1 1 1 1 1 1 50 1 1 50 1 1 1 1 1 1 50 1 1 1 1 49 1 1 1 1 1 1 69 18 1 1 1 1 
1 1 49 19 78 1 137 1 1 50 1 1 1 1 1 1 1 1 1 1 69 70 75 72 73 58 75 60 61 2 3 76 77 78 1 1 1 1 1 1 1 1 1 1 50 1 1 1 1 1 1 1 1 1 1 1 1 1 1 1 1 1 1 1 1 1 1 1 53 83 84 1 1 1 1 
49 49 1 3 78 1 137 1 49 1 1 1 1 1 1 104 105 106 1 1 85 86 87 88 89 88 90 88 89 18 19 90 93 94 1 50 1 1 1 1 1 1 1 1 1 1 50 1 1 1 1 1 49 1 1 1 1 1 1 1 1 49 1 1 50 1 1 1 69 18 1 1 1 50 1 
1 1 49 19 78 1 137 1 1 1 1 1 49 50 1 120 121 122 1 50 1 1 102 101 101 1 1 1 69 1 1 78 1 1 1 1 1 1 1 50 1 1 1 1 1 1 1 1 1 50 1 1 1 1 1 1 1 1 1 1 1 1 1 1 1 1 1 1 69 2 1 50 1 1 1 
1 1 1 3 78 132 117 103 102 1 196 197 198 1 1 101 101 102 101 101 101 100 117 117 118 1 50 1 69 1 1 78 50 1 1 1 1 1 1 50 1 1 1 1 1 1 50 1 1 1 1 1 1 1 1 1 1 1 1 1 1 1 1 1 1 50 1 1 69 18 1 1 1 1 1 
1 1 1 19 78 116 118 117 117 135 50 1 1 1 116 117 118 117 117 133 134 117 118 117 117 1 50 1 69 1 1 78 1 1 50 1 50 1 1 1 1 1 1 1 1 1 1 1 1 1 1 1 1 1 50 1 1 1 49 50 1 1 1 1 1 1 1 1 69 2 1 1 1 50 1 
193 194 195 3 78 49 148 133 134 103 101 101 101 101 100 117 117 117 118 117 151 150 149 150 150 1 1 1 69 1 1 78 1 1 1 1 1 1 1 1 1 1 1 50 1 1 1 1 1 1 1 1 49 1 1 1 1 1 1 1 1 1 1 1 1 49 1 53 83 84 1 50 1 1 1 
49 1 50 19 78 1 116 117 117 118 117 117 117 117 118 117 151 150 150 149 1 81 81 81 81 83 83 83 84 84 83 83 83 83 83 83 83 83 83 83 83 83 68 1 1 1 1 50 1 1 50 1 1 1 1 1 1 50 1 1 1 1 1 1 1 1 1 69 18 1 1 1 1 1 1 
1 1 1 19 78 1 1 148 117 117 118 117 133 134 151 149 1 1 50 1 81 1 1 1 1 1 1 1 1 1 1 49 1 1 1 1 49 1 1 1 1 19 78 1 1 1 1 1 1 1 1 1 1 1 1 1 1 1 1 1 1 1 1 53 83 84 83 83 84 1 1 1 1 50 1 
1 1 1 19 78 1 1 1 149 149 165 150 150 149 1 49 1 81 81 81 81 1 1 1 1 1 1 49 1 1 1 1 1 1 1 1 1 49 1 1 1 83 83 83 83 83 83 83 83 83 83 83 83 83 83 83 83 83 83 83 83 83 83 83 84 1 1 1 1 1 1 50 1 1 1 
1 1 1 3 78 50 1 1 1 49 1 1 1 1 50 1 81 81 1 1 1 1 1 1 1 1 1 1 1 1 1 49 1 1 1 1 49 50 1 1 1 1 49 1 50 1 1 1 1 1 1 1 1 1 1 1 1 1 1 1 1 1 1 1 1 1 1 50 1 1 1 1 49 1 1 
1 49 1 81 81 81 81 81 81 81 81 81 81 81 81 81 81 1 1 10 10 10 10 10 10 10 10 10 9 10 9 10 9 10 9 10 9 9 10 9 10 9 10 9 10 9 9 10 9 10 9 9 9 10 9 10 9 10 9 10 9 10 9 9 10 9 9 10 9 10 9 10 9 10 9 
193 194 195 50 1 1 49 1 1 1 1 1 1 1 1 1 1 1 11 24 39 24 41 42 43 24 39 24 24 24 24 24 42 43 44 29 24 24 24 41 24 24 39 24 24 41 24 42 43 44 24 39 24 41 24 39 24 24 24 39 24 42 43 44 24 24 39 24 24 41 24 24 39 24 24 
49 1 1 1 1 1 49 1 1 1 1 1 1 1 49 1 1 11 77 62 55 56 57 58 25 62 55 56 24 24 24 24 58 25 60 45 24 24 24 57 24 62 55 56 24 57 24 58 25 60 62 55 56 57 62 55 56 24 62 55 56 58 75 60 61 62 55 56 24 57 24 62 55 56 24 
