1 1 1 1 1 1 1 1 1 1 1 1 1 1 1 1 1 1 1 1 1 1 1 1 1 
1 1 1 1 1 1 1 1 1 1 1 1 1 1 1 1 1 1 1 1 1 1 1 1 1 
1 1 1 1 33 34 35 36 1 1 1 1 1 1 1 1 1 1 1 1 1 1 1 1 1 
1 1 1 1 18 50 49 3 1 1 1 1 1 1 1 1 1 1 1 1 1 1 1 1 1 
1 1 1 1 8 9 10 11 1 1 1 1 1 1 1 1 1 1 1 1 1 1 1 1 1 
1 1 1 1 1 1 1 1 1 1 1 1 1 1 1 1 1 33 34 35 36 1 1 1 1 
1 1 1 1 1 1 1 1 1 1 1 1 1 1 1 1 1 18 49 50 19 1 1 1 1 
1 1 1 1 1 1 1 1 1 1 1 1 1 1 1 1 1 8 9 10 11 1 1 1 1 
1 1 1 1 1 1 1 1 1 1 1 1 1 1 1 1 1 1 1 1 1 1 1 1 1 
1 1 1 1 1 1 1 1 1 1 1 1 1 1 1 1 1 1 1 1 1 1 1 1 1 
1 1 1 1 1 1 33 34 35 36 1 1 1 1 1 1 1 1 1 1 1 1 1 1 1 
1 1 1 1 1 1 18 49 50 19 1 1 1 1 1 1 1 1 1 1 1 1 1 1 1 
1 1 1 1 1 1 8 9 10 11 1 1 1 1 1 1 1 1 1 33 34 35 36 1 1 
1 1 1 1 1 1 1 1 1 1 1 1 1 1 1 1 1 1 1 18 50 49 19 1 1 
1 1 1 1 1 1 1 1 1 1 1 1 1 1 1 1 1 1 1 8 9 9 11 1 1 
1 1 1 1 1 1 1 1 1 1 1 1 1 1 1 1 1 1 1 1 1 1 1 1 1 
1 1 1 1 1 1 1 1 1 1 1 1 1 1 1 1 1 1 1 1 1 1 1 1 1 
1 1 1 1 1 1 1 1 1 1 1 1 1 1 1 1 1 1 1 1 1 1 1 1 33 
34 35 34 35 34 35 34 36 1 1 1 1 1 33 35 35 34 35 34 35 34 35 34 35 84 
