1 1 1 1 1 1 1 1 50 1 1 1 1 1 1 1 1 1 1 1 1 1 1 1 1 
1 1 50 1 1 1 1 1 1 1 1 1 1 1 1 1 1 1 1 1 1 1 1 50 1 
1 1 1 1 1 1 1 1 1 50 1 1 1 1 1 50 1 1 1 50 1 1 1 1 1 
1 49 1 53 18 84 84 19 68 1 1 1 1 1 1 1 1 1 1 50 1 49 1 1 1 
1 1 1 69 8 9 9 11 78 1 1 1 49 1 1 1 1 1 1 1 1 1 1 1 1 
1 1 1 85 86 87 88 93 94 1 1 50 1 1 1 1 1 1 1 1 1 1 1 1 1 
1 1 1 1 1 1 1 1 1 1 1 1 1 1 1 1 53 18 84 84 19 68 1 1 1 
1 1 1 1 1 1 1 1 50 1 1 1 49 1 1 1 69 8 9 9 11 78 49 1 1 
1 1 1 1 1 1 49 1 1 1 1 1 1 1 1 1 85 86 87 88 93 94 1 1 1 
1 1 50 1 1 1 1 1 1 1 1 1 1 1 1 1 1 1 1 1 1 1 1 1 1 
1 1 1 1 1 1 1 1 1 1 1 1 1 50 1 1 1 1 1 1 1 50 1 50 1 
1 49 1 1 1 53 18 84 84 19 68 50 1 1 1 1 1 49 1 1 1 1 1 1 1 
1 1 1 1 50 69 8 9 10 11 78 1 1 104 105 106 1 1 1 1 1 1 1 1 1 
1 1 1 1 1 85 86 87 88 93 94 1 1 120 121 122 1 1 53 18 84 84 19 68 1 
1 1 50 1 1 1 1 1 1 1 50 1 1 1 1 1 50 1 69 8 9 10 11 78 1 
1 1 1 1 50 1 1 1 1 1 1 1 1 1 1 1 1 1 85 86 89 90 93 94 1 
50 1 50 1 1 1 1 1 49 1 1 1 50 1 1 50 1 50 1 1 1 1 1 1 1 
1 1 1 1 1 50 1 1 1 1 1 1 49 1 1 1 1 1 1 1 1 1 1 1 81 
81 81 81 81 81 81 81 81 68 1 50 1 53 81 81 81 81 81 81 81 81 81 81 81 81 
